date,datetimeObj,TT,NTT,Unavailable,Total,Overall_EMA
09/15/2012,2012-09-15,0,1,0,1,1.0
01/15/2013,2013-01-15,0,1,0,1,1.0
01/20/2013,2013-01-20,0,1,0,1,1.0
01/23/2013,2013-01-23,2,0,0,2,1.3657142857142857
01/24/2013,2013-01-24,1,0,0,1,1.2458386683738796
01/28/2013,2013-01-28,1,1,0,2,1.4752004752004753
02/01/2013,2013-02-01,1,0,0,1,1.3380995985067268
02/03/2013,2013-02-03,0,1,0,1,1.2441712590080543
02/04/2013,2013-02-04,1,0,0,1,1.1781729845212219
02/13/2013,2013-02-13,0,1,0,1,1.1309716662607487
08/15/2013,2013-08-15,3,0,0,3,1.618833667690857
08/16/2013,2013-08-16,2,0,0,2,1.717242483045592
08/19/2013,2013-08-19,0,1,0,1,1.5335682654023326
08/21/2013,2013-08-21,2,0,0,2,1.6522916053509482
08/23/2013,2013-08-23,1,0,0,1,1.4870099693143408
08/26/2013,2013-08-26,1,1,0,2,1.6165558631113424
08/27/2013,2013-08-27,1,0,0,1,1.4612494674165404
08/28/2013,2013-08-28,1,0,0,1,1.3452833170234921
08/30/2013,2013-08-30,2,1,0,3,1.760719067516718
09/01/2013,2013-09-01,4,0,0,4,2.3223202570346575
09/02/2013,2013-09-02,1,0,0,1,1.9909520636978235
09/03/2013,2013-09-03,7,0,0,7,3.245451832886428
09/04/2013,2013-09-04,2,0,0,2,2.933671758121442
09/05/2013,2013-09-05,1,0,0,1,2.4497682740559927
09/06/2013,2013-09-06,9,0,0,9,4.088559467133644
09/08/2013,2013-09-08,1,0,0,1,3.3159835526374404
09/09/2013,2013-09-09,3,3,1,7,4.237377695866449
09/10/2013,2013-09-10,3,1,0,4,4.178014425291946
09/11/2013,2013-09-11,1,0,0,1,3.383321595093413
09/12/2013,2013-09-12,0,1,0,1,2.7873847726767034
09/13/2013,2013-09-13,4,1,0,5,3.340612676954142
09/14/2013,2013-09-14,3,0,0,3,3.2554509530138582
09/15/2013,2013-09-15,2,1,0,3,3.1915834030226526
09/16/2013,2013-09-16,4,0,0,4,3.393698972704068
09/17/2013,2013-09-17,1,2,0,3,3.295270058271382
09/18/2013,2013-09-18,3,0,0,3,3.2214501974296645
09/19/2013,2013-09-19,3,0,0,3,3.1660863283176655
09/20/2013,2013-09-20,6,0,0,6,3.874577412906566
09/23/2013,2013-09-23,3,0,0,3,3.6559301278865353
09/24/2013,2013-09-24,1,0,0,1,2.9919409184508705
09/25/2013,2013-09-25,1,1,0,2,2.74395381841061
09/26/2013,2013-09-26,1,0,0,1,2.307962897481805
09/27/2013,2013-09-27,0,2,0,2,2.2309718464674377
09/30/2013,2013-09-30,3,0,0,3,2.4232294966079606
10/01/2013,2013-10-01,3,0,0,3,2.5674224665688596
10/02/2013,2013-10-02,3,0,0,3,2.6755670434898753
10/03/2013,2013-10-03,1,1,1,3,2.75667539149661
10/04/2013,2013-10-04,3,1,0,4,3.067506856565729
10/07/2013,2013-10-07,3,1,0,4,3.3006303184547834
10/08/2013,2013-10-08,3,2,0,5,3.7254729794386874
10/09/2013,2013-10-09,3,0,0,3,3.5441046575444095
10/10/2013,2013-10-10,1,1,0,2,3.1580783701873436
10/11/2013,2013-10-11,3,1,0,4,3.368558827927856
10/12/2013,2013-10-12,1,0,0,1,2.7764190148417143
10/14/2013,2013-10-14,1,0,0,1,2.332314201447692
10/15/2013,2013-10-15,3,1,0,4,2.7492356931085733
10/16/2013,2013-10-16,2,0,0,2,2.5619267556718452
10/17/2013,2013-10-17,2,0,0,2,2.421445058789118
10/18/2013,2013-10-18,1,1,0,2,2.3160837896116577
10/21/2013,2013-10-21,2,2,0,4,2.7370628556344236
10/22/2013,2013-10-22,4,1,0,5,3.302797155257431
10/23/2013,2013-10-23,1,0,0,1,2.7270978561156007
10/24/2013,2013-10-24,0,2,0,2,2.545323389641061
10/25/2013,2013-10-25,2,0,0,2,2.4089925408551234
10/27/2013,2013-10-27,1,0,0,1,2.0567444029755224
10/28/2013,2013-10-28,1,0,0,1,1.7925583007321182
10/29/2013,2013-10-29,6,1,0,7,3.094418731091121
10/31/2013,2013-10-31,1,1,0,2,2.820814047444787
11/01/2013,2013-11-01,4,2,0,6,3.6156105374867846
11/03/2013,2013-11-03,0,0,1,1,2.9617079019407275
11/04/2013,2013-11-04,3,0,0,3,2.97128092646844
11/05/2013,2013-11-05,1,0,0,1,2.478460694353479
11/06/2013,2013-11-06,4,0,0,4,2.85884552105331
11/07/2013,2013-11-07,4,1,0,5,3.394134141094156
11/08/2013,2013-11-08,1,0,0,1,2.795600605565533
11/10/2013,2013-11-10,1,0,0,1,2.346700454030665
11/11/2013,2013-11-11,4,0,0,4,2.760025340622084
11/12/2013,2013-11-12,1,2,0,3,2.8200190054773495
11/14/2013,2013-11-14,1,0,0,1,2.365014254046656
11/15/2013,2013-11-15,4,1,0,5,3.0237606906016143
11/18/2013,2013-11-18,2,0,0,2,2.7678205179317974
11/19/2013,2013-11-19,6,1,0,7,3.825865388509038
11/20/2013,2013-11-20,0,1,0,1,3.1193990413516364
11/21/2013,2013-11-21,1,0,0,1,2.5895492809967724
11/22/2013,2013-11-22,0,1,0,1,2.192161960738042
11/23/2013,2013-11-23,1,0,0,1,1.8941214705481668
11/25/2013,2013-11-25,1,1,0,2,1.9205911029114824
11/27/2013,2013-11-27,2,0,0,2,1.9404433271838126
12/02/2013,2013-12-02,2,0,0,2,1.9553324953879725
12/04/2013,2013-12-04,2,0,0,2,1.966499371541043
12/09/2013,2013-12-09,3,0,0,3,2.224874528656886
12/10/2013,2013-12-10,1,1,0,2,2.1686558964924845
12/11/2013,2013-12-11,2,0,0,2,2.126491922369262
12/12/2013,2013-12-12,1,2,0,3,2.3448689417773396
12/13/2013,2013-12-13,1,0,0,1,2.00865170633255
12/16/2013,2013-12-16,0,1,0,1,1.756488779749157
12/18/2013,2013-12-18,2,0,0,2,1.8173665848119143
12/19/2013,2013-12-19,0,1,0,1,1.6130249386088191
12/22/2013,2013-12-22,1,0,0,1,1.459768703956549
12/26/2013,2013-12-26,0,2,0,2,1.5948265279674552
01/01/2014,2014-01-01,0,1,0,1,1.4461198959755557
01/03/2014,2014-01-03,0,1,0,1,1.3345899219816466
01/06/2014,2014-01-06,3,0,0,3,1.7509424414862913
01/09/2014,2014-01-09,0,1,0,1,1.5632068311146994
01/13/2014,2014-01-13,0,1,0,1,1.4224051233360138
01/14/2014,2014-01-14,0,1,0,1,1.316803842502004
01/17/2014,2014-01-17,1,1,0,2,1.4876028818765104
01/27/2014,2014-01-27,1,0,0,1,1.3657021614073788
02/01/2014,2014-02-01,0,1,0,1,1.2742766210555319
02/04/2014,2014-02-04,1,0,0,1,1.2057074657916478
02/06/2014,2014-02-06,2,0,0,2,1.4042805993437384
02/07/2014,2014-02-07,1,1,0,2,1.5532104495078052
02/11/2014,2014-02-11,0,1,0,1,1.4149078371308528
02/12/2014,2014-02-12,0,1,0,1,1.3111808778481389
02/14/2014,2014-02-14,0,2,0,2,1.483385658386105
02/15/2014,2014-02-15,0,1,0,1,1.3625392437895782
02/20/2014,2014-02-20,3,0,0,3,1.7719044328421847
02/21/2014,2014-02-21,2,1,0,3,2.078928324631639
02/24/2014,2014-02-24,1,0,0,1,1.8091962434737288
02/26/2014,2014-02-26,0,1,0,1,1.6068971826052962
02/27/2014,2014-02-27,1,0,0,1,1.455172886953972
02/28/2014,2014-02-28,2,0,0,2,1.591379665215479
03/03/2014,2014-03-03,1,2,0,3,1.9435347489116095
03/04/2014,2014-03-04,0,1,0,1,1.707651061683707
03/06/2014,2014-03-06,1,0,0,1,1.5307382962627805
03/07/2014,2014-03-07,0,1,0,1,1.3980537221970852
03/10/2014,2014-03-10,1,2,0,3,1.7985402916478141
03/12/2014,2014-03-12,0,4,0,4,2.348905218735861
03/14/2014,2014-03-14,0,1,0,1,2.0116789140518954
03/18/2014,2014-03-18,2,0,0,2,2.0087591855389215
03/25/2014,2014-03-25,0,3,0,3,2.256569389154191
03/26/2014,2014-03-26,1,1,0,2,2.1924270418656433
03/31/2014,2014-03-31,0,1,0,1,1.8943202813992324
04/01/2014,2014-04-01,1,0,0,1,1.6707402110494243
04/02/2014,2014-04-02,0,2,0,2,1.7530551582870684
04/07/2014,2014-04-07,0,1,0,1,1.5647913687153012
04/09/2014,2014-04-09,0,2,0,2,1.673593526536476
04/15/2014,2014-04-15,0,1,0,1,1.505195144902357
04/17/2014,2014-04-17,0,1,0,1,1.3788963586767677
04/22/2014,2014-04-22,0,1,0,1,1.2841722690075756
04/25/2014,2014-04-25,1,1,0,2,1.4631292017556816
04/28/2014,2014-04-28,0,1,0,1,1.3473469013167612
05/16/2014,2014-05-16,1,0,0,1,1.2605101759875708
05/19/2014,2014-05-19,0,1,0,1,1.195382631990678
05/21/2014,2014-05-21,1,0,0,1,1.1465369739930085
05/30/2014,2014-05-30,1,0,0,1,1.1099027304947564
06/01/2014,2014-06-01,0,1,0,1,1.0824270478710674
06/11/2014,2014-06-11,0,1,0,1,1.0618202859033006
06/13/2014,2014-06-13,0,1,0,1,1.0463652144274753
06/24/2014,2014-06-24,0,1,0,1,1.0347739108206064
07/01/2014,2014-07-01,2,0,0,2,1.2760804331154547
07/09/2014,2014-07-09,0,1,0,1,1.207060324836591
08/11/2014,2014-08-11,3,0,0,3,1.6552952436274435
08/14/2014,2014-08-14,1,0,0,1,1.4914714327205825
08/18/2014,2014-08-18,0,2,0,2,1.618603574540437
08/20/2014,2014-08-20,2,0,0,2,1.7139526809053278
08/21/2014,2014-08-21,2,0,0,2,1.785464510678996
08/23/2014,2014-08-23,1,0,0,1,1.5890983830092469
08/26/2014,2014-08-26,0,2,0,2,1.6918237872569353
08/27/2014,2014-08-27,2,0,0,2,1.7688678404427016
08/28/2014,2014-08-28,1,0,0,1,1.5766508803320263
09/01/2014,2014-09-01,6,2,0,8,3.18248816024902
09/02/2014,2014-09-02,2,0,0,2,2.886866120186765
09/03/2014,2014-09-03,8,5,0,13,5.415149590140074
09/04/2014,2014-09-04,0,2,0,2,4.561362192605055
09/05/2014,2014-09-05,3,0,0,3,4.171021644453791
09/09/2014,2014-09-09,6,1,1,8,5.1282662333403435
09/10/2014,2014-09-10,1,0,0,1,4.096199675005257
09/12/2014,2014-09-12,7,0,0,7,4.822149756253943
09/15/2014,2014-09-15,3,1,0,4,4.616612317190457
09/16/2014,2014-09-16,4,0,0,4,4.462459237892842
09/17/2014,2014-09-17,2,1,0,3,4.096844428419631
09/18/2014,2014-09-18,0,2,0,2,3.5726333213147234
09/19/2014,2014-09-19,1,1,0,2,3.1794749909860425
09/22/2014,2014-09-22,5,0,0,5,3.634606243239532
09/23/2014,2014-09-23,1,0,0,1,2.9759546824296486
09/24/2014,2014-09-24,3,2,0,5,3.481966011822237
09/25/2014,2014-09-25,1,0,0,1,2.8614745088666775
09/26/2014,2014-09-26,2,1,0,3,2.896105881650008
09/29/2014,2014-09-29,5,0,0,5,3.4220794112375064
09/30/2014,2014-09-30,1,2,0,3,3.3165595584281298
10/01/2014,2014-10-01,3,1,0,4,3.4874196688210977
10/02/2014,2014-10-02,1,0,0,1,2.865564751615823
10/03/2014,2014-10-03,4,1,0,5,3.3991735637118676
10/06/2014,2014-10-06,5,1,0,6,4.049380172783901
10/07/2014,2014-10-07,0,1,0,1,3.2870351295879257
10/08/2014,2014-10-08,1,1,0,2,2.965276347190944
10/09/2014,2014-10-09,4,0,0,4,3.2239572603932083
10/10/2014,2014-10-10,6,0,0,6,3.9179679452949063
10/13/2014,2014-10-13,2,2,0,4,3.9384759589711797
10/15/2014,2014-10-15,2,1,0,3,3.7038569692283847
10/16/2014,2014-10-16,3,1,0,4,3.7778927269212885
10/17/2014,2014-10-17,5,1,0,6,4.333419545190966
10/19/2014,2014-10-19,1,0,0,1,3.5000646588932245
10/20/2014,2014-10-20,2,1,0,3,3.3750484941699184
10/21/2014,2014-10-21,0,2,0,2,3.031286370627439
10/22/2014,2014-10-22,1,0,0,1,2.523464777970579
10/23/2014,2014-10-23,1,2,0,3,2.6425985834779344
10/24/2014,2014-10-24,3,2,0,5,3.231948937608451
10/27/2014,2014-10-27,1,3,0,4,3.4239617032063383
10/28/2014,2014-10-28,3,0,0,3,3.317971277404754
10/29/2014,2014-10-29,3,0,0,3,3.2384784580535655
10/30/2014,2014-10-30,0,1,0,1,2.6788588435401737
10/31/2014,2014-10-31,5,2,0,7,3.7591441326551305
11/01/2014,2014-11-01,1,0,0,1,3.069358099491348
11/03/2014,2014-11-03,3,0,0,3,3.052018574618511
11/04/2014,2014-11-04,2,0,0,2,2.789013930963883
11/05/2014,2014-11-05,1,0,0,1,2.341760448222912
11/06/2014,2014-11-06,2,0,0,2,2.256320336167184
11/07/2014,2014-11-07,3,0,0,3,2.442240252125388
11/10/2014,2014-11-10,1,0,0,1,2.081680189094041
11/12/2014,2014-11-12,1,0,0,1,1.8112601418205305
11/13/2014,2014-11-13,3,1,0,4,2.358445106365398
11/14/2014,2014-11-14,1,0,0,1,2.0188338297740485
11/15/2014,2014-11-15,0,1,0,1,1.7641253723305363
11/16/2014,2014-11-16,1,0,0,1,1.5730940292479023
11/17/2014,2014-11-17,5,1,0,6,2.679820521935927
11/18/2014,2014-11-18,1,1,0,2,2.509865391451945
11/20/2014,2014-11-20,2,2,0,4,2.8823990435889586
11/21/2014,2014-11-21,7,3,0,10,4.661799282691719
11/24/2014,2014-11-24,2,0,0,2,3.9963494620187894
11/25/2014,2014-11-25,1,1,0,2,3.497262096514092
11/27/2014,2014-11-27,1,0,0,1,2.8729465723855685
12/01/2014,2014-12-01,5,1,0,6,3.6547099292891767
12/02/2014,2014-12-02,1,0,0,1,2.9910324469668823
12/05/2014,2014-12-05,0,2,0,2,2.7432743352251614
12/10/2014,2014-12-10,1,1,0,2,2.5574557514188707
12/11/2014,2014-12-11,2,1,0,3,2.668091813564153
12/15/2014,2014-12-15,1,0,0,1,2.2510688601731146
12/17/2014,2014-12-17,3,1,0,4,2.688301645129836
12/18/2014,2014-12-18,1,1,0,2,2.5162262338473766
12/19/2014,2014-12-19,1,1,0,2,2.3871696753855325
12/26/2014,2014-12-26,0,2,0,2,2.2903772565391494
12/30/2014,2014-12-30,2,1,0,3,2.467782942404362
01/01/2015,2015-01-01,0,1,0,1,2.1008372068032712
01/04/2015,2015-01-04,1,0,0,1,1.8256279051024533
01/05/2015,2015-01-05,0,1,0,1,1.61922092882684
01/06/2015,2015-01-06,0,1,0,1,1.4644156966201298
01/07/2015,2015-01-07,1,1,0,2,1.5983117724650975
01/13/2015,2015-01-13,1,0,0,1,1.448733829348823
01/14/2015,2015-01-14,0,2,0,2,1.5865503720116174
01/15/2015,2015-01-15,5,1,0,6,2.689912779008713
01/16/2015,2015-01-16,1,0,0,1,2.267434584256535
01/20/2015,2015-01-20,0,2,0,2,2.2005759381924013
01/22/2015,2015-01-22,2,1,0,3,2.400431953644301
01/28/2015,2015-01-28,3,0,0,3,2.550323965233226
02/02/2015,2015-02-02,1,0,0,1,2.162742973924919
02/06/2015,2015-02-06,0,1,0,1,1.8720572304436893
02/09/2015,2015-02-09,0,1,0,1,1.654042922832767
02/10/2015,2015-02-10,0,2,0,2,1.7405321921245753
02/12/2015,2015-02-12,1,0,0,1,1.5553991440934316
02/17/2015,2015-02-17,2,1,0,3,1.9165493580700739
02/24/2015,2015-02-24,0,1,0,1,1.6874120185525554
02/25/2015,2015-02-25,1,2,0,3,2.015559013914417
02/26/2015,2015-02-26,0,1,0,1,1.7616692604358126
02/27/2015,2015-02-27,0,2,0,2,1.8212519453268594
03/02/2015,2015-03-02,0,2,0,2,1.8659389589951445
03/03/2015,2015-03-03,1,1,0,2,1.8994542192463584
03/05/2015,2015-03-05,0,2,0,2,1.9245906644347688
03/09/2015,2015-03-09,0,3,0,3,2.1934429983260766
03/10/2015,2015-03-10,1,0,0,1,1.8950822487445573
03/13/2015,2015-03-13,1,7,0,8,3.4213116865584183
03/15/2015,2015-03-15,1,0,0,1,2.8159837649188133
03/16/2015,2015-03-16,0,4,0,4,3.1119878236891103
03/20/2015,2015-03-20,0,1,0,1,2.5839908677668326
03/30/2015,2015-03-30,0,1,0,1,2.1879931508251245
03/31/2015,2015-03-31,0,1,0,1,1.8909948631188433
04/01/2015,2015-04-01,0,4,0,4,2.4182461473391323
04/02/2015,2015-04-02,0,1,0,1,2.063684610504349
04/08/2015,2015-04-08,0,2,0,2,2.0477634578782618
04/09/2015,2015-04-09,1,1,1,3,2.2858225934086964
04/11/2015,2015-04-11,1,0,0,1,1.9643669450565222
04/12/2015,2015-04-12,0,1,0,1,1.7232752087923917
04/13/2015,2015-04-13,1,0,0,1,1.5424564065942938
04/16/2015,2015-04-16,1,2,0,3,1.9068423049457204
04/21/2015,2015-04-21,0,2,0,2,1.9301317287092903
04/22/2015,2015-04-22,0,1,0,1,1.6975987965319677
04/28/2015,2015-04-28,0,5,0,5,2.523199097398976
05/01/2015,2015-05-01,0,6,0,6,3.3923993230492324
05/04/2015,2015-05-04,0,2,0,2,3.0442994922869246
05/11/2015,2015-05-11,0,1,0,1,2.533224619215193
05/27/2015,2015-05-27,0,2,0,2,2.3999184644113947
06/01/2015,2015-06-01,0,3,0,3,2.549938848308546
06/04/2015,2015-06-04,0,1,0,1,2.1624541362314096
06/08/2015,2015-06-08,1,4,0,5,2.871840602173557
06/17/2015,2015-06-17,1,0,0,1,2.4038804516301675
06/18/2015,2015-06-18,0,1,0,1,2.0529103387226257
06/19/2015,2015-06-19,1,0,0,1,1.7896827540419693
06/23/2015,2015-06-23,0,1,0,1,1.592262065531477
06/24/2015,2015-06-24,0,1,0,1,1.4441965491486075
06/30/2015,2015-06-30,0,2,0,2,1.5831474118614557
08/01/2015,2015-08-01,1,0,0,1,1.4373605588960916
08/10/2015,2015-08-10,2,0,0,2,1.5780204191720688
08/12/2015,2015-08-12,1,0,0,1,1.4335153143790516
08/13/2015,2015-08-13,0,1,0,1,1.3251364857842887
08/14/2015,2015-08-14,2,0,0,2,1.4938523643382164
08/17/2015,2015-08-17,2,0,0,2,1.6203892732536624
08/18/2015,2015-08-18,1,0,0,1,1.4652919549402468
08/20/2015,2015-08-20,4,0,0,4,2.0989689662051854
08/25/2015,2015-08-25,2,1,0,3,2.324226724653889
08/26/2015,2015-08-26,1,0,0,1,1.9931700434904165
08/27/2015,2015-08-27,1,0,0,1,1.7448775326178123
08/28/2015,2015-08-28,3,0,0,3,2.0586581494633593
08/31/2015,2015-08-31,1,1,0,2,2.0439936120975193
09/01/2015,2015-09-01,4,4,0,8,3.53299520907314
09/02/2015,2015-09-02,2,0,0,2,3.149746406804855
09/04/2015,2015-09-04,3,0,0,3,3.1123098051036413
09/08/2015,2015-09-08,1,1,0,2,2.8342323538277308
09/09/2015,2015-09-09,1,0,0,1,2.375674265370798
09/11/2015,2015-09-11,5,1,0,6,3.281755699028099
09/12/2015,2015-09-12,1,0,0,1,2.711316774271074
09/14/2015,2015-09-14,2,0,0,2,2.5334875807033055
09/15/2015,2015-09-15,5,0,0,5,3.1501156855274792
09/16/2015,2015-09-16,1,0,0,1,2.6125867641456093
09/17/2015,2015-09-17,2,0,0,2,2.459440073109207
09/18/2015,2015-09-18,2,1,0,3,2.5945800548319053
09/21/2015,2015-09-21,1,0,0,1,2.1959350411239287
09/22/2015,2015-09-22,4,0,0,4,2.6469512808429463
09/23/2015,2015-09-23,5,0,0,5,3.23521346063221
09/24/2015,2015-09-24,3,0,0,3,3.1764100954741576
09/25/2015,2015-09-25,7,2,0,9,4.632307571605619
09/26/2015,2015-09-26,2,0,0,2,3.974230678704214
09/28/2015,2015-09-28,2,0,0,2,3.480673009028161
09/29/2015,2015-09-29,3,0,0,3,3.3605047567711206
09/30/2015,2015-09-30,1,0,0,1,2.7703785675783403
10/01/2015,2015-10-01,5,0,0,5,3.3277839256837556
10/02/2015,2015-10-02,4,2,0,6,3.9958379442628167
10/05/2015,2015-10-05,1,0,0,1,3.2468784581971124
10/06/2015,2015-10-06,3,0,0,3,3.1851588436478346
10/07/2015,2015-10-07,1,0,0,1,2.6388691327358758
10/08/2015,2015-10-08,3,3,0,6,3.479151849551907
10/09/2015,2015-10-09,1,3,0,4,3.6093638871639304
10/12/2015,2015-10-12,2,0,0,2,3.207022915372948
10/13/2015,2015-10-13,5,0,0,5,3.655267186529711
10/14/2015,2015-10-14,2,0,0,2,3.2414503898972833
10/15/2015,2015-10-15,2,2,0,4,3.4310877924229626
10/16/2015,2015-10-16,1,1,0,2,3.073315844317222
10/19/2015,2015-10-19,2,1,0,3,3.0549868832379166
10/20/2015,2015-10-20,3,0,0,3,3.0412401624284375
10/21/2015,2015-10-21,3,0,0,3,3.0309301218213283
10/22/2015,2015-10-22,0,0,1,1,2.523197591365996
10/23/2015,2015-10-23,1,0,0,1,2.142398193524497
10/26/2015,2015-10-26,1,1,1,3,2.3567986451433725
10/27/2015,2015-10-27,2,1,0,3,2.5175989838575292
10/28/2015,2015-10-28,2,1,0,3,2.6381992378931467
10/29/2015,2015-10-29,3,0,0,3,2.72864942841986
10/30/2015,2015-10-30,1,0,0,1,2.296487071314895
11/01/2015,2015-11-01,4,3,0,7,3.4723653034861717
11/02/2015,2015-11-02,4,1,0,5,3.854273977614629
11/03/2015,2015-11-03,1,0,0,1,3.1407054832109718
11/04/2015,2015-11-04,3,0,0,3,3.105529112408229
11/05/2015,2015-11-05,1,2,0,3,3.079146834306172
11/06/2015,2015-11-06,3,0,0,3,3.0593601257296292
11/09/2015,2015-11-09,1,0,0,1,2.5445200942972215
11/10/2015,2015-11-10,0,1,0,1,2.1583900707229158
11/11/2015,2015-11-11,1,0,0,1,1.8687925530421867
11/12/2015,2015-11-12,2,1,0,3,2.15159441478164
11/13/2015,2015-11-13,1,0,0,1,1.8636958110862298
11/15/2015,2015-11-15,1,0,0,1,1.6477718583146723
11/19/2015,2015-11-19,3,0,0,3,1.9858288937360042
11/20/2015,2015-11-20,1,0,0,1,1.7393716703020032
11/21/2015,2015-11-21,0,1,0,1,1.5545287527265026
11/24/2015,2015-11-24,0,1,0,1,1.415896564544877
11/25/2015,2015-11-25,2,1,0,3,1.8119224234086577
12/01/2015,2015-12-01,1,0,0,1,1.6089418175564933
12/04/2015,2015-12-04,1,1,0,2,1.70670636316737
12/07/2015,2015-12-07,2,0,0,2,1.7800297723755276
12/11/2015,2015-12-11,1,0,0,1,1.5850223292816457
12/15/2015,2015-12-15,1,0,0,1,1.4387667469612342
12/16/2015,2015-12-16,0,1,0,1,1.3290750602209256
12/29/2015,2015-12-29,2,0,0,2,1.4968062951656942
01/01/2016,2016-01-01,0,2,0,2,1.6226047213742707
01/04/2016,2016-01-04,4,5,0,9,3.4669535410307035
01/06/2016,2016-01-06,0,1,0,1,2.8502151557730273
01/07/2016,2016-01-07,1,0,0,1,2.38766136682977
01/08/2016,2016-01-08,0,1,0,1,2.0407460251223277
01/11/2016,2016-01-11,1,0,0,1,1.7805595188417458
01/12/2016,2016-01-12,0,3,0,3,2.0854196391313096
01/14/2016,2016-01-14,1,0,0,1,1.8140647293484822
01/20/2016,2016-01-20,0,1,0,1,1.6105485470113616
01/25/2016,2016-01-25,0,4,0,4,2.207911410258521
01/26/2016,2016-01-26,1,1,0,2,2.1559335576938907
01/27/2016,2016-01-27,1,0,0,1,1.866950168270418
01/28/2016,2016-01-28,1,0,0,1,1.6502126262028134
01/29/2016,2016-01-29,3,1,0,4,2.23765946965211
02/01/2016,2016-02-01,2,0,0,2,2.1782446022390825
02/02/2016,2016-02-02,0,2,0,2,2.1336834516793117
02/08/2016,2016-02-08,0,1,0,1,1.8502625887594837
02/12/2016,2016-02-12,0,1,0,1,1.6376969415696128
02/17/2016,2016-02-17,0,1,0,1,1.4782727061772094
02/24/2016,2016-02-24,1,1,0,2,1.6087045296329072
02/26/2016,2016-02-26,1,0,0,1,1.4565283972246803
02/29/2016,2016-02-29,0,5,0,5,2.3423962979185102
03/01/2016,2016-03-01,1,0,0,1,2.0067972234388827
03/04/2016,2016-03-04,2,2,0,4,2.505097917579162
03/08/2016,2016-03-08,0,1,0,1,2.1288234381843716
03/09/2016,2016-03-09,1,0,0,1,1.8466175786382786
03/15/2016,2016-03-15,0,2,0,2,1.8849631839787089
03/29/2016,2016-03-29,0,2,0,2,1.9137223879840317
03/30/2016,2016-03-30,0,1,0,1,1.6852917909880238
03/31/2016,2016-03-31,1,0,0,1,1.5139688432410179
04/01/2016,2016-04-01,0,1,0,1,1.3854766324307632
04/07/2016,2016-04-07,0,1,0,1,1.2891074743230724
04/11/2016,2016-04-11,0,1,0,1,1.2168306057423042
04/12/2016,2016-04-12,0,1,0,1,1.1626229543067281
04/15/2016,2016-04-15,0,1,0,1,1.121967215730046
04/21/2016,2016-04-21,0,2,0,2,1.3414754117975345
05/03/2016,2016-05-03,0,2,0,2,1.506106558848151
05/12/2016,2016-05-12,0,1,0,1,1.379579919136113
05/20/2016,2016-05-20,0,2,0,2,1.534684939352085
05/24/2016,2016-05-24,0,2,0,2,1.6510137045140638
06/13/2016,2016-06-13,0,2,0,2,1.7382602783855479
06/15/2016,2016-06-15,0,1,0,1,1.553695208789161
06/16/2016,2016-06-16,0,2,0,2,1.6652714065918708
06/24/2016,2016-06-24,0,1,0,1,1.498953554943903
07/07/2016,2016-07-07,0,1,0,1,1.3742151662079272
08/01/2016,2016-08-01,1,0,0,1,1.2806613746559452
08/26/2016,2016-08-26,1,0,0,1,1.2104960309919588
08/29/2016,2016-08-29,0,0,1,1,1.157872023243969
09/01/2016,2016-09-01,0,1,0,1,1.1184040174329768
09/11/2016,2016-09-11,20,9,0,29,8.088803013074735
09/12/2016,2016-09-12,1,0,0,1,6.316602259806051
09/13/2016,2016-09-13,1,0,0,1,4.9874516948545375
09/14/2016,2016-09-14,0,1,0,1,3.990588771140903
09/15/2016,2016-09-15,7,6,1,14,6.492941578355678
09/19/2016,2016-09-19,1,0,0,1,5.119706183766758
09/21/2016,2016-09-21,1,0,0,1,4.089779637825068
09/22/2016,2016-09-22,1,0,0,1,3.317334728368801
09/23/2016,2016-09-23,9,1,0,10,4.988001046276601
09/28/2016,2016-09-28,2,0,0,2,4.241000784707451
09/29/2016,2016-09-29,1,0,2,3,3.930750588530588
09/30/2016,2016-09-30,8,4,0,12,5.948062941397941
10/03/2016,2016-10-03,3,0,0,3,5.211047206048455
10/05/2016,2016-10-05,1,0,0,1,4.1582854045363415
10/07/2016,2016-10-07,4,4,0,8,5.118714053402256
10/10/2016,2016-10-10,3,0,0,3,4.589035540051691
10/11/2016,2016-10-11,2,0,0,2,3.9417766550387685
10/12/2016,2016-10-12,2,0,0,2,3.4563324912790763
10/14/2016,2016-10-14,5,3,0,8,4.592249368459307
10/17/2016,2016-10-17,0,0,1,1,3.6941870263444803
10/18/2016,2016-10-18,1,1,0,2,3.2706402697583603
10/21/2016,2016-10-21,4,6,0,10,4.952980202318771
10/24/2016,2016-10-24,4,0,0,4,4.714735151739078
10/26/2016,2016-10-26,2,0,0,2,4.036051363804309
10/28/2016,2016-10-28,6,4,0,10,5.527038522853232
11/03/2016,2016-11-03,0,1,0,1,4.395278892139924
11/04/2016,2016-11-04,9,0,0,9,5.546459169104943
11/05/2016,2016-11-05,1,0,0,1,4.409844376828707
11/10/2016,2016-11-10,0,1,0,1,3.55738328262153
11/11/2016,2016-11-11,1,1,0,2,3.1680374619661475
11/14/2016,2016-11-14,4,0,0,4,3.3760280964746108
11/15/2016,2016-11-15,0,2,0,2,3.0320210723559584
11/18/2016,2016-11-18,1,3,0,4,3.274015804266969
11/22/2016,2016-11-22,0,2,0,2,2.9555118532002265
11/23/2016,2016-11-23,1,0,0,1,2.46663388990017
11/30/2016,2016-11-30,2,1,0,3,2.5999754174251275
12/02/2016,2016-12-02,0,1,0,1,2.1999815630688455
12/09/2016,2016-12-09,1,4,0,5,2.899986172301634
12/14/2016,2016-12-14,1,0,0,1,2.4249896292262254
12/16/2016,2016-12-16,2,1,0,3,2.568742221919669
12/18/2016,2016-12-18,1,0,0,1,2.1765566664397515
12/20/2016,2016-12-20,1,0,0,1,1.8824174998298135
12/23/2016,2016-12-23,0,4,0,4,2.41181312487236
12/30/2016,2016-12-30,1,0,0,1,2.05885984365427
01/06/2017,2017-01-06,0,2,0,2,2.0441448827407025
01/13/2017,2017-01-13,1,0,0,1,1.7831086620555268
01/20/2017,2017-01-20,0,7,0,7,3.0873314965416454
01/23/2017,2017-01-23,0,1,0,1,2.565498622406234
01/26/2017,2017-01-26,0,1,0,1,2.1741239668046752
01/27/2017,2017-01-27,0,5,0,5,2.8805929751035064
02/03/2017,2017-02-03,0,3,0,3,2.9104447313276296
02/09/2017,2017-02-09,1,0,0,1,2.432833548495722
02/10/2017,2017-02-10,1,3,0,4,2.8246251613717916
02/16/2017,2017-02-16,0,1,0,1,2.3684688710288437
02/17/2017,2017-02-17,0,5,0,5,3.0263516532716332
02/24/2017,2017-02-24,1,2,0,3,3.019763739953725
02/28/2017,2017-02-28,2,0,0,2,2.7648228049652936
03/03/2017,2017-03-03,0,1,0,1,2.32361710372397
03/10/2017,2017-03-10,0,4,1,5,2.9927128277929773
03/17/2017,2017-03-17,0,2,0,2,2.7445346208447328
03/21/2017,2017-03-21,0,1,0,1,2.3084009656335494
03/23/2017,2017-03-23,0,1,0,1,1.981300724225162
03/24/2017,2017-03-24,1,1,0,2,1.9859755431688715
03/31/2017,2017-03-31,0,2,1,3,2.2394816573766536
04/07/2017,2017-04-07,1,1,0,2,2.17961124303249
04/14/2017,2017-04-14,0,3,0,3,2.3847084322743677
04/21/2017,2017-04-21,0,2,0,2,2.288531324205776
05/02/2017,2017-05-02,0,1,0,1,1.966398493154332
05/05/2017,2017-05-05,0,1,0,1,1.724798869865749
05/07/2017,2017-05-07,1,0,0,1,1.5435991523993118
05/19/2017,2017-05-19,0,1,0,1,1.4076993642994837
05/22/2017,2017-05-22,0,1,0,1,1.3057745232246127
05/26/2017,2017-05-26,0,2,0,2,1.4793308924184594
06/02/2017,2017-06-02,0,1,0,1,1.3594981693138444
06/07/2017,2017-06-07,0,1,0,1,1.2696236269853831
06/15/2017,2017-06-15,0,3,0,3,1.7022177202390374
06/23/2017,2017-06-23,0,1,0,1,1.526663290179278
06/27/2017,2017-06-27,0,1,0,1,1.3949974676344583
08/03/2017,2017-08-03,1,0,0,1,1.2962481007258437
08/21/2017,2017-08-21,1,0,0,1,1.2221860755443827
08/24/2017,2017-08-24,2,0,0,2,1.416639556658287
09/01/2017,2017-09-01,1,0,0,1,1.3124796674937151
09/10/2017,2017-09-10,25,3,0,28,7.984359750620288
09/11/2017,2017-09-11,1,0,0,1,6.238269812965216
09/15/2017,2017-09-15,5,2,0,7,6.428702359723912
09/19/2017,2017-09-19,1,0,0,1,5.071526769792934
09/22/2017,2017-09-22,13,4,0,17,8.0536450773447
09/24/2017,2017-09-24,2,0,0,2,6.540233808008526
09/27/2017,2017-09-27,1,0,0,1,5.155175356006394
09/29/2017,2017-09-29,12,4,2,18,8.366381517004797
10/03/2017,2017-10-03,1,0,0,1,6.524786137753598
10/05/2017,2017-10-05,0,1,0,1,5.143589603315197
10/06/2017,2017-10-06,12,6,0,18,8.3576922024864
10/09/2017,2017-10-09,1,0,0,1,6.518269151864799
10/13/2017,2017-10-13,6,1,0,7,6.6387018638986
10/18/2017,2017-10-18,0,1,0,1,5.229026397923949
10/20/2017,2017-10-20,9,4,1,14,7.421769798442963
10/27/2017,2017-10-27,8,3,0,11,8.316327348832223
10/31/2017,2017-10-31,0,2,0,2,6.737245511624167
11/01/2017,2017-11-01,3,1,0,4,6.052934133718125
11/03/2017,2017-11-03,7,3,0,10,7.039700600288594
11/05/2017,2017-11-05,0,1,0,1,5.5297754502164445
11/07/2017,2017-11-07,1,0,0,1,4.397331587662333
11/09/2017,2017-11-09,0,3,0,3,4.04799869074675
11/10/2017,2017-11-10,5,2,0,7,4.785999018060062
11/15/2017,2017-11-15,0,1,0,1,3.8394992635450467
11/16/2017,2017-11-16,1,0,0,1,3.129624447658785
11/17/2017,2017-11-17,4,1,0,5,3.597218335744089
11/18/2017,2017-11-18,1,0,0,1,2.9479137518080663
11/20/2017,2017-11-20,1,1,0,2,2.7109353138560497
11/21/2017,2017-11-21,2,0,0,2,2.5332014853920373
11/22/2017,2017-11-22,1,3,0,4,2.899901114044028
11/29/2017,2017-11-29,0,1,0,1,2.4249258355330205
12/01/2017,2017-12-01,1,1,0,2,2.3186943766497654
12/08/2017,2017-12-08,4,2,0,6,3.2390207824873243
12/15/2017,2017-12-15,2,5,0,7,4.179265586865493
12/22/2017,2017-12-22,1,2,0,3,3.8844491901491196
12/27/2017,2017-12-27,1,0,0,1,3.1633368926118397
12/29/2017,2017-12-29,4,0,0,4,3.3725026694588798
01/08/2018,2018-01-08,1,2,0,3,3.27937700209416
01/10/2018,2018-01-10,1,0,0,1,2.70953275157062
01/12/2018,2018-01-12,1,2,0,3,2.7821495636779647
01/17/2018,2018-01-17,2,0,0,2,2.5866121727584734
01/19/2018,2018-01-19,1,4,0,5,3.189959129568855
01/20/2018,2018-01-20,0,2,0,2,2.892469347176641
01/24/2018,2018-01-24,2,0,0,2,2.6693520103824806
01/25/2018,2018-01-25,1,0,0,1,2.2520140077868605
01/26/2018,2018-01-26,0,5,0,5,2.9390105058401454
02/02/2018,2018-02-02,1,2,0,3,2.954257879380109
02/09/2018,2018-02-09,0,3,0,3,2.9656934095350813
02/15/2018,2018-02-15,1,0,0,1,2.474270057151311
02/16/2018,2018-02-16,1,1,0,2,2.355702542863483
02/23/2018,2018-02-23,1,1,0,2,2.2667769071476123
03/02/2018,2018-03-02,1,2,0,3,2.450082680360709
03/09/2018,2018-03-09,1,4,0,5,3.087562010270532
03/16/2018,2018-03-16,1,4,0,5,3.5656715077028993
03/23/2018,2018-03-23,0,2,0,2,3.1742536307771747
03/30/2018,2018-03-30,0,3,0,3,3.130690223082881
04/06/2018,2018-04-06,0,2,0,2,2.8480176673121607
04/11/2018,2018-04-11,1,0,0,1,2.3860132504841203
04/13/2018,2018-04-13,0,5,0,5,3.0395099378630905
04/20/2018,2018-04-20,0,1,0,1,2.529632453397318
04/27/2018,2018-04-27,1,1,0,2,2.397224340047988
05/04/2018,2018-05-04,3,2,0,5,3.0479182550359916
05/11/2018,2018-05-11,0,2,0,2,2.7859386912769932
05/18/2018,2018-05-18,0,2,0,2,2.5894540184577446
05/25/2018,2018-05-25,0,5,0,5,3.1920905138433087
06/01/2018,2018-06-01,0,1,0,1,2.6440678853824813
06/08/2018,2018-06-08,0,1,0,1,2.233050914036861
06/15/2018,2018-06-15,1,0,0,1,1.9247881855276456
06/29/2018,2018-06-29,0,1,0,1,1.6935911391457343
07/06/2018,2018-07-06,2,0,0,2,1.770193354359301
08/12/2018,2018-08-12,1,0,0,1,1.5776450157694757
08/13/2018,2018-08-13,1,0,0,1,1.4332337618271067
08/19/2018,2018-08-19,1,0,0,1,1.32492532137033
09/06/2018,2018-09-06,1,0,0,1,1.2436939910277474
09/09/2018,2018-09-09,3,0,0,3,1.6827704932708107
09/10/2018,2018-09-10,15,3,4,22,6.762077869953109
09/11/2018,2018-09-11,1,0,2,3,5.821558402464832
09/14/2018,2018-09-14,5,1,1,7,6.116168801848624
09/21/2018,2018-09-21,10,0,1,11,7.337126601386468
09/24/2018,2018-09-24,1,0,0,1,5.75284495103985
09/25/2018,2018-09-25,1,0,0,1,4.564633713279887
09/28/2018,2018-09-28,6,6,1,13,6.673475284959916
10/02/2018,2018-10-02,0,0,1,1,5.255106463719937
10/03/2018,2018-10-03,1,0,0,1,4.1913298477899525
10/05/2018,2018-10-05,9,4,0,13,6.3934973858424655
10/12/2018,2018-10-12,7,4,3,14,8.29512303938185
10/19/2018,2018-10-19,7,1,0,8,8.221342279536387
10/25/2018,2018-10-25,1,0,0,1,6.41600670965229
10/26/2018,2018-10-26,5,3,1,9,7.062005032239218
11/01/2018,2018-11-01,0,1,0,1,5.5465037741794125
11/02/2018,2018-11-02,3,1,0,4,5.159877830634559
11/09/2018,2018-11-09,2,3,0,5,5.119908372975919
11/15/2018,2018-11-15,0,2,0,2,4.339931279731939
11/16/2018,2018-11-16,2,1,0,3,4.004948459798954
11/21/2018,2018-11-21,1,0,1,2,3.5037113448492154
11/30/2018,2018-11-30,3,2,1,6,4.127783508636911
12/03/2018,2018-12-03,0,1,0,1,3.3458376314776834
12/07/2018,2018-12-07,1,5,4,10,5.0093782236082625
12/14/2018,2018-12-14,1,2,1,4,4.757033667706197
12/21/2018,2018-12-21,2,2,0,4,4.567775250779648
12/28/2018,2018-12-28,1,0,1,2,3.9258314380847357
01/03/2019,2019-01-03,0,2,0,2,3.444373578563552
01/07/2019,2019-01-07,1,0,0,1,2.8332801839226636
01/11/2019,2019-01-11,2,3,0,5,3.374960137941998
01/18/2019,2019-01-18,1,6,0,7,4.281220103456499
01/25/2019,2019-01-25,0,1,0,1,3.460915077592374
01/28/2019,2019-01-28,0,0,1,1,2.84568630819428
02/01/2019,2019-02-01,2,1,1,4,3.13426473114571
02/08/2019,2019-02-08,1,3,3,7,4.100698548359283
02/10/2019,2019-02-10,1,0,0,1,3.325523911269462
02/15/2019,2019-02-15,0,1,0,1,2.744142933452096
02/22/2019,2019-02-22,2,5,1,8,4.058107200089072
03/01/2019,2019-03-01,0,3,1,4,4.043580400066804
03/08/2019,2019-03-08,1,3,0,4,4.032685300050103
03/15/2019,2019-03-15,1,1,0,2,3.524513975037577
03/21/2019,2019-03-21,0,1,0,1,2.8933854812781825
03/22/2019,2019-03-22,1,0,0,1,2.4200391109586366
03/23/2019,2019-03-23,0,0,1,1,2.0650293332189773
03/29/2019,2019-03-29,0,1,0,1,1.7987719999142329
04/12/2019,2019-04-12,0,2,0,2,1.8490789999356747
04/15/2019,2019-04-15,0,1,0,1,1.6368092499517561
04/19/2019,2019-04-19,0,2,0,2,1.7276069374638172
05/10/2019,2019-05-10,0,5,0,5,2.545705203097863
05/20/2019,2019-05-20,0,1,0,1,2.159278902323397
05/24/2019,2019-05-24,0,1,0,1,1.8694591767425477
05/31/2019,2019-05-31,0,2,0,2,1.9020943825569108
06/14/2019,2019-06-14,0,0,1,1,1.6765707869176831
06/21/2019,2019-06-21,1,0,0,1,1.5074280901882624
07/02/2019,2019-07-02,0,1,0,1,1.3805710676411966
08/20/2019,2019-08-20,1,0,0,1,1.2854283007308973
08/29/2019,2019-08-29,2,0,0,2,1.464071225548173
09/02/2019,2019-09-02,1,0,0,1,1.3480534191611295
09/03/2019,2019-09-03,1,0,0,1,1.261040064370847
09/09/2019,2019-09-09,1,1,0,2,1.445780048278135
09/10/2019,2019-09-10,1,0,0,1,1.3343350362086013
09/11/2019,2019-09-11,1,1,0,2,1.500751277156451
09/12/2019,2019-09-12,22,8,2,32,9.12556345786734
09/17/2019,2019-09-17,5,2,0,7,8.594172593400504
09/18/2019,2019-09-18,1,0,0,1,6.695629445050378
09/20/2019,2019-09-20,5,1,0,6,6.521722083787784
09/27/2019,2019-09-27,7,4,0,11,7.641291562840839
10/01/2019,2019-10-01,0,1,0,1,5.980968672130628
10/02/2019,2019-10-02,0,1,0,1,4.735726504097971
10/04/2019,2019-10-04,5,2,1,8,5.551794878073478
10/07/2019,2019-10-07,1,1,0,2,4.663846158555108
10/08/2019,2019-10-08,1,0,0,1,3.747884618916331
10/10/2019,2019-10-10,3,3,1,7,4.560913464187248
10/11/2019,2019-10-11,1,1,0,2,3.920685098140436
10/16/2019,2019-10-16,0,1,0,1,3.190513823605327
10/17/2019,2019-10-17,0,1,0,1,2.642885367703995
10/18/2019,2019-10-18,6,2,0,8,3.9821640257779967
10/21/2019,2019-10-21,1,1,0,2,3.4866230193334977
10/22/2019,2019-10-22,1,0,0,1,2.864967264500123
10/23/2019,2019-10-23,4,0,0,4,3.148725448375093
10/25/2019,2019-10-25,2,1,0,3,3.1115440862813197
10/28/2019,2019-10-28,1,0,0,1,2.5836580647109897
10/29/2019,2019-10-29,0,1,0,1,2.187743548533242
11/01/2019,2019-11-01,1,1,0,2,2.1408076613999314
11/02/2019,2019-11-02,0,0,1,1,1.8556057460499484
11/03/2019,2019-11-03,1,0,0,1,1.6417043095374613
11/06/2019,2019-11-06,0,1,0,1,1.4812782321530957
11/07/2019,2019-11-07,3,2,1,6,2.610958674114822
11/08/2019,2019-11-08,1,1,0,2,2.458219005586116
11/11/2019,2019-11-11,0,1,0,1,2.093664254189587
11/13/2019,2019-11-13,1,0,0,1,1.8202481906421903
11/14/2019,2019-11-14,1,0,0,1,1.6151861429816428
11/15/2019,2019-11-15,1,1,0,2,1.7113896072362322
11/20/2019,2019-11-20,1,1,0,2,1.7835422054271743
11/21/2019,2019-11-21,0,1,0,1,1.5876566540703807
11/27/2019,2019-11-27,0,2,0,2,1.6907424905527857
12/01/2019,2019-12-01,0,2,0,2,1.7680568679145894
12/06/2019,2019-12-06,1,5,0,6,2.826042650935942
12/07/2019,2019-12-07,1,0,0,1,2.3695319882019565
12/09/2019,2019-12-09,0,1,0,1,2.0271489911514675
12/12/2019,2019-12-12,0,3,0,3,2.2703617433636007
12/15/2019,2019-12-15,1,0,0,1,1.9527713075227005
12/17/2019,2019-12-17,1,1,0,2,1.9645784806420254
12/20/2019,2019-12-20,1,2,1,4,2.473433860481519
12/26/2019,2019-12-26,1,0,0,1,2.105075395361139
01/03/2020,2020-01-03,1,0,0,1,1.8288065465208543
01/04/2020,2020-01-04,1,0,0,1,1.6216049098906407
01/10/2020,2020-01-10,2,2,0,4,2.2162036824179805
01/17/2020,2020-01-17,1,1,0,2,2.1621527618134855
01/21/2020,2020-01-21,0,1,0,1,1.871614571360114
01/24/2020,2020-01-24,1,2,0,3,2.1537109285200855
01/31/2020,2020-01-31,1,2,0,3,2.365283196390064
02/01/2020,2020-02-01,0,1,0,1,2.023962397292548
02/07/2020,2020-02-07,0,1,0,1,1.7679717979694107
02/12/2020,2020-02-12,1,0,0,1,1.575978848477058
02/14/2020,2020-02-14,0,1,0,1,1.4319841363577934
02/20/2020,2020-02-20,0,1,0,1,1.323988102268345
02/21/2020,2020-02-21,0,2,0,2,1.4929910767012586
02/27/2020,2020-02-27,0,3,0,3,1.8697433075259442
02/28/2020,2020-02-28,0,1,0,1,1.6523074806444582
03/05/2020,2020-03-05,0,3,0,3,1.9892306104833437
03/10/2020,2020-03-10,0,1,0,1,1.7419229578625077
03/11/2020,2020-03-11,0,1,0,1,1.556442218396881
03/23/2020,2020-03-23,0,1,0,1,1.4173316637976605
03/26/2020,2020-03-26,0,1,0,1,1.3129987478482452
04/03/2020,2020-04-03,1,0,1,2,1.4847490608861837
04/17/2020,2020-04-17,1,0,0,1,1.3635617956646378
05/01/2020,2020-05-01,0,2,0,2,1.5226713467484785
05/15/2020,2020-05-15,0,2,0,2,1.642003510061359
06/03/2020,2020-06-03,0,1,0,1,1.4815026325460192
06/05/2020,2020-06-05,0,1,0,1,1.3611269744095142
06/10/2020,2020-06-10,1,3,0,4,2.0208452308071356
07/01/2020,2020-07-01,0,1,0,1,1.7656339231053517
07/17/2020,2020-07-17,0,1,0,1,1.5742254423290138
09/07/2020,2020-09-07,3,3,0,6,2.6806690817467604
09/16/2020,2020-09-16,5,0,0,5,3.2605018113100708
09/17/2020,2020-09-17,1,0,0,1,2.695376358482553
09/18/2020,2020-09-18,1,1,0,2,2.5215322688619146
09/23/2020,2020-09-23,2,1,0,3,2.641149201646436
09/25/2020,2020-09-25,3,0,0,3,2.7308619012348267
09/30/2020,2020-09-30,1,1,0,2,2.5481464259261197
10/01/2020,2020-10-01,1,0,0,1,2.1611098194445897
10/02/2020,2020-10-02,1,0,0,1,1.8708323645834422
10/06/2020,2020-10-06,1,0,0,1,1.6531242734375817
10/11/2020,2020-10-11,2,4,0,6,2.7398432050781865
10/18/2020,2020-10-18,4,0,0,4,3.05488240380864
10/20/2020,2020-10-20,2,0,0,2,2.7911618028564797
10/23/2020,2020-10-23,1,1,0,2,2.5933713521423596
10/25/2020,2020-10-25,2,0,0,2,2.4450285141067694
10/26/2020,2020-10-26,0,1,0,1,2.083771385580077
10/27/2020,2020-10-27,0,1,0,1,1.8128285391850576
10/28/2020,2020-10-28,3,0,0,3,2.1096214043887933
10/29/2020,2020-10-29,2,0,0,2,2.082216053291595
11/03/2020,2020-11-03,2,0,0,2,2.061662039968696
11/05/2020,2020-11-05,1,0,0,1,1.796246529976522
11/12/2020,2020-11-12,3,0,0,3,2.0971848974823915
11/16/2020,2020-11-16,0,1,0,1,1.8228886731117935
11/17/2020,2020-11-17,1,1,0,2,1.867166504833845
11/20/2020,2020-11-20,1,0,0,1,1.6503748786253838
11/23/2020,2020-11-23,1,0,0,1,1.4877811589690377
11/24/2020,2020-11-24,1,0,0,1,1.3658358692267782
12/01/2020,2020-12-01,2,0,0,2,1.524376901920084
12/03/2020,2020-12-03,1,0,0,1,1.3932826764400628
12/10/2020,2020-12-10,1,1,0,2,1.5449620073300472
12/12/2020,2020-12-12,1,0,0,1,1.4087215054975353
12/18/2020,2020-12-18,1,0,0,1,1.3065411291231515
12/24/2020,2020-12-24,3,1,0,4,1.9799058468423638
01/08/2021,2021-01-08,2,2,0,4,2.484929385131773
01/09/2021,2021-01-09,1,0,0,1,2.1136970388488296
01/15/2021,2021-01-15,2,4,0,6,3.0852727791366226
01/21/2021,2021-01-21,0,1,0,1,2.5639545843524667
01/27/2021,2021-01-27,1,1,0,2,2.42296593826435
02/09/2021,2021-02-09,0,2,0,2,2.3172244536982625
02/12/2021,2021-02-12,0,2,0,2,2.237918340273697
02/22/2021,2021-02-22,1,0,0,1,1.9284387552052726
02/25/2021,2021-02-25,1,1,0,2,1.9463290664039545
02/28/2021,2021-02-28,0,1,0,1,1.7097467998029658
03/03/2021,2021-03-03,1,0,0,1,1.5323100998522245
03/05/2021,2021-03-05,4,3,0,7,2.8992325748891683
03/12/2021,2021-03-12,0,6,0,6,3.6744244311668766
03/13/2021,2021-03-13,0,1,0,1,3.0058183233751574
03/15/2021,2021-03-15,0,1,0,1,2.5043637425313676
03/17/2021,2021-03-17,1,2,0,3,2.6282728068985257
03/19/2021,2021-03-19,0,1,0,1,2.2212046051738943
03/25/2021,2021-03-25,1,3,0,4,2.6659034538804205
03/26/2021,2021-03-26,0,2,0,2,2.499427590410315
04/02/2021,2021-04-02,0,6,0,6,3.374570692807737
04/04/2021,2021-04-04,0,1,0,1,2.780928019605802
04/08/2021,2021-04-08,1,0,0,1,2.3356960147043515
04/10/2021,2021-04-10,0,1,0,1,2.0017720110282635
04/14/2021,2021-04-14,0,2,0,2,2.0013290082711976
04/20/2021,2021-04-20,1,0,0,1,1.7509967562033981
04/22/2021,2021-04-22,0,2,0,2,1.8132475671525485
04/27/2021,2021-04-27,0,1,0,1,1.6099356753644114
04/30/2021,2021-04-30,0,2,0,2,1.7074517565233087
05/03/2021,2021-05-03,0,1,0,1,1.5305888173924815
05/05/2021,2021-05-05,1,0,0,1,1.397941613044361
05/13/2021,2021-05-13,0,1,0,1,1.2984562097832706
05/14/2021,2021-05-14,0,2,0,2,1.473842157337453
05/18/2021,2021-05-18,0,3,0,3,1.8553816180030898
05/19/2021,2021-05-19,0,3,0,3,2.1415362135023175
05/20/2021,2021-05-20,0,1,0,1,1.8561521601267381
05/28/2021,2021-05-28,0,1,0,1,1.6421141200950535
06/04/2021,2021-06-04,0,2,0,2,1.7315855900712902
06/07/2021,2021-06-07,0,1,0,1,1.5486891925534678
06/08/2021,2021-06-08,0,2,0,2,1.6615168944151009
06/14/2021,2021-06-14,0,1,0,1,1.4961376708113254
06/21/2021,2021-06-21,0,1,0,1,1.372103253108494
06/30/2021,2021-06-30,0,2,0,2,1.5290774398313707
07/06/2021,2021-07-06,0,1,0,1,1.3968080798735278
07/29/2021,2021-07-29,0,1,0,1,1.2976060599051458
08/24/2021,2021-08-24,0,1,0,1,1.2232045449288593
08/30/2021,2021-08-30,2,1,0,3,1.6674034086966447
09/01/2021,2021-09-01,1,0,0,1,1.5005525565224835
09/08/2021,2021-09-08,5,3,0,8,3.125414417391863
09/09/2021,2021-09-09,0,1,0,1,2.594060813043897
09/10/2021,2021-09-10,1,0,0,1,2.1955456097829225
09/13/2021,2021-09-13,1,1,0,2,2.146659207337192
09/14/2021,2021-09-14,2,1,0,3,2.359994405502894
09/15/2021,2021-09-15,2,0,0,2,2.2699958041271704
09/16/2021,2021-09-16,0,1,0,1,1.9524968530953777
09/17/2021,2021-09-17,1,0,0,1,1.7143726398215333
09/20/2021,2021-09-20,3,3,0,6,2.78577947986615
09/22/2021,2021-09-22,3,1,0,4,3.089334609899613
09/23/2021,2021-09-23,1,0,0,1,2.5670009574247095
09/24/2021,2021-09-24,2,0,0,2,2.425250718068532
09/25/2021,2021-09-25,5,1,0,6,3.318938038551399
09/29/2021,2021-09-29,2,3,0,5,3.7392035289135497
09/30/2021,2021-09-30,3,0,0,3,3.5544026466851624
10/03/2021,2021-10-03,1,0,0,1,2.9158019850138714
10/05/2021,2021-10-05,3,0,0,3,2.9368514887604036
10/09/2021,2021-10-09,3,2,0,5,3.452638616570303
10/10/2021,2021-10-10,0,1,0,1,2.839478962427727
10/11/2021,2021-10-11,2,0,0,2,2.629609221820795
10/14/2021,2021-10-14,2,0,0,2,2.472206916365596
10/18/2021,2021-10-18,0,1,0,1,2.104155187274197
10/19/2021,2021-10-19,0,1,0,1,1.8281163904556477
10/20/2021,2021-10-20,1,0,0,1,1.6210872928417357
10/21/2021,2021-10-21,4,0,0,4,2.215815469631302
10/25/2021,2021-10-25,2,0,0,2,2.1618616022234765
10/27/2021,2021-10-27,2,1,0,3,2.3713962016676073
10/28/2021,2021-10-28,1,0,0,1,2.0285471512507054
11/01/2021,2021-11-01,2,0,0,2,2.021410363438029
11/02/2021,2021-11-02,1,0,0,1,1.7660577725785216
11/03/2021,2021-11-03,3,1,0,4,2.324543329433891
11/04/2021,2021-11-04,0,3,0,3,2.493407497075418
11/05/2021,2021-11-05,1,1,0,2,2.3700556228065635
11/07/2021,2021-11-07,1,0,0,1,2.0275417171049224
11/09/2021,2021-11-09,1,4,0,5,2.7706562878286918
11/11/2021,2021-11-11,3,1,0,4,3.077992215871519
11/12/2021,2021-11-12,2,2,0,4,3.3084941619036394
11/15/2021,2021-11-15,1,0,0,1,2.7313706214277294
11/16/2021,2021-11-16,0,1,0,1,2.2985279660707967
11/17/2021,2021-11-17,3,3,0,6,3.223895974553098
11/18/2021,2021-11-18,0,1,0,1,2.6679219809148234
11/19/2021,2021-11-19,1,1,0,2,2.500941485686117
11/26/2021,2021-11-26,0,1,0,1,2.1257061142645877
11/27/2021,2021-11-27,2,2,0,4,2.5942795856984406
11/30/2021,2021-11-30,2,2,0,4,2.9457096892738304
12/01/2021,2021-12-01,1,0,0,1,2.4592822669553724
12/05/2021,2021-12-05,2,3,0,5,3.0944617002165296
12/07/2021,2021-12-07,0,3,0,3,3.0708462751623973
12/08/2021,2021-12-08,1,0,0,1,2.5531347063717975
12/09/2021,2021-12-09,2,0,0,2,2.414851029778848
12/12/2021,2021-12-12,1,0,0,1,2.061138272334136
12/14/2021,2021-12-14,1,2,0,3,2.295853704250602
12/20/2021,2021-12-20,2,4,0,6,3.221890278187952
12/26/2021,2021-12-26,2,2,0,4,3.416417708640964
12/29/2021,2021-12-29,1,0,0,1,2.812313281480723
01/03/2022,2022-01-03,1,0,0,1,2.359234961110542
01/04/2022,2022-01-04,0,1,0,1,2.0194262208329063
01/07/2022,2022-01-07,1,1,0,2,2.0145696656246797
01/16/2022,2022-01-16,1,1,0,2,2.0109272492185095
01/20/2022,2022-01-20,0,3,0,3,2.258195436913882
01/24/2022,2022-01-24,0,1,0,1,1.9436465776854115
01/25/2022,2022-01-25,1,1,0,2,1.9577349332640586
01/27/2022,2022-01-27,0,1,0,1,1.718301199948044
02/01/2022,2022-02-01,0,2,0,2,1.7887258999610332
02/02/2022,2022-02-02,0,2,0,2,1.8415444249707749
02/03/2022,2022-02-03,0,1,0,1,1.6311583187280811
02/05/2022,2022-02-05,1,0,0,1,1.4733687390460608
02/07/2022,2022-02-07,0,1,0,1,1.3550265542845454
02/10/2022,2022-02-10,0,3,0,3,1.7662699157134092
02/18/2022,2022-02-18,3,4,0,7,3.0747024367850573
02/22/2022,2022-02-22,0,3,0,3,3.056026827588793
02/23/2022,2022-02-23,1,0,0,1,2.5420201206915944
02/24/2022,2022-02-24,1,0,0,1,2.156515090518696
02/28/2022,2022-02-28,0,1,0,1,1.8673863178890218
03/02/2022,2022-03-02,1,1,0,2,1.9005397384167664
03/06/2022,2022-03-06,1,2,0,3,2.1754048038125746
03/08/2022,2022-03-08,0,1,0,1,1.8815536028594309
03/09/2022,2022-03-09,1,1,0,2,1.911165202144573
03/10/2022,2022-03-10,1,2,0,3,2.1833739016084297
03/17/2022,2022-03-17,0,3,0,3,2.387530426206322
03/23/2022,2022-03-23,0,4,0,4,2.7906478196547417
03/25/2022,2022-03-25,0,2,0,2,2.592985864741056
03/29/2022,2022-03-29,0,3,0,3,2.694739398555792
03/30/2022,2022-03-30,0,1,0,1,2.271054548916844
04/05/2022,2022-04-05,1,1,0,2,2.203290911687633
04/07/2022,2022-04-07,0,1,0,1,1.9024681837657247
04/11/2022,2022-04-11,0,1,0,1,1.6768511378242936
04/13/2022,2022-04-13,0,4,0,4,2.2576383533682205
04/19/2022,2022-04-19,0,1,0,1,1.9432287650261653
04/25/2022,2022-04-25,0,3,0,3,2.207421573769624
04/26/2022,2022-04-26,1,0,0,1,1.905566180327218
05/04/2022,2022-05-04,1,5,0,6,2.9291746352454133
05/09/2022,2022-05-09,0,2,0,2,2.69688097643406
05/13/2022,2022-05-13,1,1,0,2,2.5226607323255448
05/19/2022,2022-05-19,0,1,0,1,2.1419955492441582
05/20/2022,2022-05-20,0,1,0,1,1.8564966619331187
05/25/2022,2022-05-25,0,1,0,1,1.642372496449839
05/26/2022,2022-05-26,0,1,0,1,1.481779372337379
05/27/2022,2022-05-27,0,1,0,1,1.3613345292530343
05/30/2022,2022-05-30,0,5,0,5,2.2710008969397757
06/02/2022,2022-06-02,0,1,0,1,1.9532506727048318
06/13/2022,2022-06-13,0,2,0,2,1.9649380045286238
06/22/2022,2022-06-22,0,1,0,1,1.7237035033964678
08/17/2022,2022-08-17,1,0,0,1,1.542777627547351
08/29/2022,2022-08-29,1,0,0,1,1.407083220660513
09/01/2022,2022-09-01,4,2,0,6,2.555312415495385
09/06/2022,2022-09-06,1,0,0,1,2.1664843116215384
09/08/2022,2022-09-08,1,0,0,1,1.8748632337161537
09/12/2022,2022-09-12,2,1,0,3,2.156147425287115
09/14/2022,2022-09-14,4,0,0,4,2.6171105689653364
09/15/2022,2022-09-15,1,4,0,5,3.2128329267240026
09/16/2022,2022-09-16,2,1,0,3,3.1596246950430023
09/19/2022,2022-09-19,1,2,0,3,3.119718521282252
09/20/2022,2022-09-20,2,0,0,2,2.8397888909616884
09/22/2022,2022-09-22,4,1,0,5,3.3798416682212666
09/24/2022,2022-09-24,0,1,0,1,2.7848812511659498
09/28/2022,2022-09-28,4,3,0,7,3.8386609383744625
10/02/2022,2022-10-02,0,1,0,1,3.128995703780847
10/04/2022,2022-10-04,3,1,0,4,3.3467467778356355
10/05/2022,2022-10-05,2,0,0,2,3.0100600833767266
10/06/2022,2022-10-06,2,0,0,2,2.757545062532545
10/10/2022,2022-10-10,7,2,0,9,4.318158796899409
10/11/2022,2022-10-11,2,0,0,2,3.738619097674557
10/13/2022,2022-10-13,4,3,0,7,4.553964323255918
10/18/2022,2022-10-18,4,5,0,9,5.665473242441938
10/20/2022,2022-10-20,1,0,0,1,4.499104931831453
10/21/2022,2022-10-21,0,2,0,2,3.8743286988735894
10/26/2022,2022-10-26,2,2,0,4,3.9057465241551923
10/27/2022,2022-10-27,1,0,0,1,3.179309893116394
10/28/2022,2022-10-28,2,0,0,2,2.8844824198372954
11/01/2022,2022-11-01,2,4,0,6,3.663361814877972
11/05/2022,2022-11-05,1,2,0,3,3.497521361158479
11/08/2022,2022-11-08,7,0,0,7,4.373141020868859
11/09/2022,2022-11-09,0,1,0,1,3.5298557656516443
11/11/2022,2022-11-11,2,2,0,4,3.647391824238733
11/14/2022,2022-11-14,1,1,0,2,3.23554386817905
11/15/2022,2022-11-15,1,0,0,1,2.6766579011342873
11/17/2022,2022-11-17,1,2,0,3,2.7574934258507153
11/18/2022,2022-11-18,1,1,0,2,2.568120069388036
11/20/2022,2022-11-20,1,1,0,2,2.426090052041027
11/22/2022,2022-11-22,10,1,0,11,4.56956753903077
11/28/2022,2022-11-28,1,2,0,3,4.177175654273078
11/29/2022,2022-11-29,2,0,0,2,3.632881740704808
12/02/2022,2022-12-02,0,1,0,1,2.9746613055286057
12/04/2022,2022-12-04,1,0,0,1,2.480995979146454
12/05/2022,2022-12-05,1,0,0,1,2.1107469843598405
12/08/2022,2022-12-08,0,3,0,3,2.3330602382698804
12/20/2022,2022-12-20,3,3,0,6,3.249795178702411
01/04/2023,2023-01-04,1,0,0,1,2.687346384026808
01/10/2023,2023-01-10,2,1,0,3,2.765509788020106
01/16/2023,2023-01-16,1,2,0,3,2.8241323410150794
01/19/2023,2023-01-19,1,1,0,2,2.6180992557613094
01/27/2023,2023-01-27,0,3,0,3,2.713574441820982
02/02/2023,2023-02-02,2,2,0,4,3.0351808313657367
02/09/2023,2023-02-09,2,1,0,3,3.0263856235243027
02/16/2023,2023-02-16,0,1,0,1,2.519789217643227
02/17/2023,2023-02-17,0,3,0,3,2.63984191323242
02/27/2023,2023-02-27,0,2,0,2,2.479881434924315
03/08/2023,2023-03-08,0,5,0,5,3.1099110761932365
03/10/2023,2023-03-10,0,2,0,2,2.8324333071449272
03/17/2023,2023-03-17,0,1,0,1,2.374324980358695
03/22/2023,2023-03-22,0,2,0,2,2.2807437352690214
03/24/2023,2023-03-24,0,1,0,1,1.960557801451766
03/29/2023,2023-03-29,1,1,0,2,1.9704183510888245
04/11/2023,2023-04-11,0,3,0,3,2.227813763316618
04/18/2023,2023-04-18,0,2,0,2,2.1708603224874636
05/01/2023,2023-05-01,0,2,0,2,2.1281452418655977
05/10/2023,2023-05-10,1,3,0,4,2.5961089313991983
05/16/2023,2023-05-16,2,4,0,6,3.447081698549399
05/23/2023,2023-05-23,0,1,0,1,2.835311273912049
06/05/2023,2023-06-05,0,2,0,2,2.6264834554340366
06/13/2023,2023-06-13,0,3,0,3,2.7198625915755272
06/23/2023,2023-06-23,0,2,0,2,2.5398969436816454
07/05/2023,2023-07-05,0,1,0,1,2.154922707761234
08/01/2023,2023-08-01,1,0,0,1,1.8661920308209254
08/10/2023,2023-08-10,1,0,0,1,1.6496440231156941
08/28/2023,2023-08-28,1,0,0,1,1.4872330173367705
09/01/2023,2023-09-01,4,3,0,7,2.865424763002578
09/08/2023,2023-09-08,6,2,0,8,4.149068572251934
09/09/2023,2023-09-09,1,0,0,1,3.36180142918895
09/12/2023,2023-09-12,2,1,0,3,3.2713510718917127
09/13/2023,2023-09-13,1,0,0,1,2.7035133039187844
09/14/2023,2023-09-14,0,2,0,2,2.5276349779390883
09/18/2023,2023-09-18,6,4,0,10,4.395726233454316
09/24/2023,2023-09-24,2,0,0,2,3.796794675090737
09/26/2023,2023-09-26,7,0,0,7,4.597596006318053
09/30/2023,2023-09-30,5,3,0,8,5.44819700473854
10/02/2023,2023-10-02,1,0,0,1,4.336147753553904
10/03/2023,2023-10-03,3,3,0,6,4.752110815165428
10/05/2023,2023-10-05,2,0,0,2,4.064083111374071
10/06/2023,2023-10-06,0,1,0,1,3.2980623335305532
10/09/2023,2023-10-09,3,0,0,3,3.223546750147915
10/12/2023,2023-10-12,3,0,0,3,3.1676600626109366
10/16/2023,2023-10-16,2,0,0,2,2.875745046958202
10/19/2023,2023-10-19,2,0,0,2,2.6568087852186513
10/20/2023,2023-10-20,1,0,0,1,2.242606588913988
10/22/2023,2023-10-22,4,1,0,5,2.931954941685491
10/30/2023,2023-10-30,8,0,0,8,4.198966206264118
11/07/2023,2023-11-07,7,6,0,13,6.39922465469809
11/08/2023,2023-11-08,0,1,0,1,5.049418491023567
11/13/2023,2023-11-13,7,2,0,9,6.037063868267675
11/17/2023,2023-11-17,0,1,0,1,4.777797901200756
11/27/2023,2023-11-27,4,0,0,4,4.583348425900567
11/30/2023,2023-11-30,1,0,0,1,3.6875113194254254
12/04/2023,2023-12-04,2,0,0,2,3.265633489569069
12/12/2023,2023-12-12,1,0,0,1,2.6992251171768014
12/13/2023,2023-12-13,4,2,0,6,3.5244188378826014
12/19/2023,2023-12-19,3,2,0,5,3.893314128411951
01/02/2024,2024-01-02,1,0,0,1,3.169985596308963
01/05/2024,2024-01-05,0,2,0,2,2.8774891972317223
01/10/2024,2024-01-10,2,3,0,5,3.408116897923792
01/15/2024,2024-01-15,1,1,0,2,3.056087673442844
01/24/2024,2024-01-24,3,3,0,6,3.7920657550821333
01/29/2024,2024-01-29,1,0,0,1,3.0940493163116
02/08/2024,2024-02-08,0,3,0,3,3.0705369872337003
02/15/2024,2024-02-15,4,3,0,7,4.052902740425275
02/21/2024,2024-02-21,0,1,0,1,3.2896770553189563
03/11/2024,2024-03-11,1,11,0,12,5.467257791489217
03/25/2024,2024-03-25,0,1,0,1,4.350443343616913
03/26/2024,2024-03-26,0,1,0,1,3.5128325077126847
04/02/2024,2024-04-02,0,3,0,3,3.3846243807845138
04/14/2024,2024-04-14,0,2,0,2,3.0384682855883853
04/18/2024,2024-04-18,0,4,0,4,3.278851214191289
04/25/2024,2024-04-25,0,1,0,1,2.7091384106434666
04/30/2024,2024-04-30,0,1,0,1,2.2818538079826
05/09/2024,2024-05-09,0,1,0,1,1.9613903559869499
05/30/2024,2024-05-30,1,4,0,5,2.7210427669902124
06/05/2024,2024-06-05,0,1,0,1,2.2907820752426593
06/26/2024,2024-06-26,1,0,0,1,1.9680865564319945
08/20/2024,2024-08-20,9,5,0,14,4.976064917323996
08/24/2024,2024-08-24,0,1,0,1,3.982048687992997
08/26/2024,2024-08-26,1,1,0,2,3.486536515994748
09/02/2024,2024-09-02,1,0,0,1,2.864902386996061
09/05/2024,2024-09-05,3,0,0,3,2.8986767902470456
09/09/2024,2024-09-09,7,1,0,8,4.174007592685284
09/12/2024,2024-09-12,7,1,0,8,5.130505694513963
09/16/2024,2024-09-16,2,1,0,3,4.597879270885472
09/17/2024,2024-09-17,1,0,0,1,3.698409453164104
09/19/2024,2024-09-19,1,1,0,2,3.273807089873078
09/20/2024,2024-09-20,7,0,0,7,4.205355317404809
09/23/2024,2024-09-23,1,0,0,1,3.404016488053607
09/24/2024,2024-09-24,1,0,0,1,2.8030123660402047
09/25/2024,2024-09-25,3,0,0,3,2.8522592745301534
10/01/2024,2024-10-01,2,4,0,6,3.6391944558976155
10/02/2024,2024-10-02,0,2,0,2,3.229395841923212
10/07/2024,2024-10-07,3,0,0,3,3.172046881442409
10/09/2024,2024-10-09,2,2,0,4,3.379035161081807
10/14/2024,2024-10-14,2,2,0,4,3.5342763708113556
10/21/2024,2024-10-21,8,2,0,10,5.150707278108516
10/22/2024,2024-10-22,2,0,0,2,4.363030458581387
10/29/2024,2024-10-29,5,3,0,8,5.27227284393604
11/04/2024,2024-11-04,2,0,0,2,4.45420463295203
11/05/2024,2024-11-05,3,5,0,8,5.340653474714022
11/08/2024,2024-11-08,1,0,0,1,4.255490106035516
11/11/2024,2024-11-11,2,3,0,5,4.441617579526637
11/14/2024,2024-11-14,3,0,0,3,4.0812131846449775
11/18/2024,2024-11-18,0,1,0,1,3.310909888483733
11/26/2024,2024-11-26,1,1,0,2,2.9831824163627996
11/27/2024,2024-11-27,1,3,0,4,3.2373868122721
12/05/2024,2024-12-05,2,3,0,5,3.6780401092040753
12/06/2024,2024-12-06,0,1,0,1,3.0085300819030567
12/10/2024,2024-12-10,2,0,0,2,2.7563975614272924
12/11/2024,2024-12-11,0,2,0,2,2.567298171070469
12/17/2024,2024-12-17,1,1,0,2,2.4254736283028517
12/24/2024,2024-12-24,0,3,0,3,2.569105221227139
01/16/2025,2025-01-16,1,3,0,4,2.9268289159203538
01/23/2025,2025-01-23,1,1,0,2,2.695121686940265
01/25/2025,2025-01-25,1,1,0,2,2.5213412652051987
01/30/2025,2025-01-30,0,1,0,1,2.141005948903899
02/06/2025,2025-02-06,2,5,0,7,3.3557544616779245
02/19/2025,2025-02-19,0,1,0,1,2.766815846258443
03/05/2025,2025-03-05,0,3,0,3,2.825111884693832
03/07/2025,2025-03-07,0,2,0,2,2.618833913520374
03/11/2025,2025-03-11,1,1,0,2,2.4641254351402804
03/21/2025,2025-03-21,1,2,0,3,2.5980940763552103
04/03/2025,2025-04-03,0,1,0,1,2.1985705572664074
04/08/2025,2025-04-08,1,2,0,3,2.3989279179498055
08/26/2025,2025-08-26,3,0,0,3,2.549195938462354
09/04/2025,2025-09-04,1,0,0,1,2.1618969538467656
09/05/2025,2025-09-05,1,0,0,1,1.8714227153850742
09/08/2025,2025-09-08,1,0,0,1,1.6535670365388058
09/10/2025,2025-09-10,2,0,0,2,1.7401752774041044
09/12/2025,2025-09-12,2,0,0,2,1.8051314580530784
09/16/2025,2025-09-16,2,0,0,2,1.8538485935398088
09/18/2025,2025-09-18,1,0,0,1,1.6403864451548567
09/24/2025,2025-09-24,7,0,0,7,2.9802898338661428
09/25/2025,2025-09-25,1,0,0,1,2.485217375399607
10/01/2025,2025-10-01,2,0,0,2,2.3639130315497052
10/06/2025,2025-10-06,3,0,0,3,2.522934773662279
10/08/2025,2025-10-08,0,1,0,1,2.142201080246709
10/14/2025,2025-10-14,3,6,0,9,3.856650810185032
10/15/2025,2025-10-15,3,0,0,3,3.642488107638774
10/16/2025,2025-10-16,0,1,0,1,2.98186608072908
