date,datetimeObj,TT,NTT,Unavailable,Total,Overall_EMA
09/15/2012,2012-09-15,0,1,0,1,1.0
01/15/2013,2013-01-15,0,1,0,1,1.0
01/20/2013,2013-01-20,0,1,0,1,1.0
01/23/2013,2013-01-23,2,0,0,2,1.3657142857142857
01/24/2013,2013-01-24,1,0,0,1,1.2458386683738796
01/28/2013,2013-01-28,1,1,0,2,1.4752004752004753
02/01/2013,2013-02-01,1,0,0,1,1.3380995985067268
02/03/2013,2013-02-03,0,1,0,1,1.2441712590080543
02/04/2013,2013-02-04,1,0,0,1,1.1781729845212219
02/13/2013,2013-02-13,0,1,0,1,1.1309716662607487
08/15/2013,2013-08-15,3,0,0,3,1.618833667690857
08/16/2013,2013-08-16,2,0,0,2,1.717242483045592
08/19/2013,2013-08-19,0,1,0,1,1.5335682654023326
08/21/2013,2013-08-21,2,0,0,2,1.6522916053509482
08/23/2013,2013-08-23,1,0,0,1,1.4870099693143408
08/26/2013,2013-08-26,1,1,0,2,1.6165558631113424
08/27/2013,2013-08-27,1,0,0,1,1.4612494674165404
08/28/2013,2013-08-28,1,0,0,1,1.3452833170234921
08/30/2013,2013-08-30,2,1,0,3,1.760719067516718
09/01/2013,2013-09-01,3,0,0,3,2.0715249319053783
09/02/2013,2013-09-02,1,0,0,1,1.8030050488347578
09/03/2013,2013-09-03,5,0,0,5,2.603682039619297
09/04/2013,2013-09-04,2,0,0,2,2.4525593494622804
09/05/2013,2013-09-05,1,0,0,1,2.0890547747771206
09/06/2013,2013-09-06,9,0,0,9,3.818092256928956
09/08/2013,2013-09-08,1,0,0,1,3.1131713299726385
09/09/2013,2013-09-09,3,3,1,7,4.085290000849288
09/10/2013,2013-09-10,3,1,0,4,4.063960729035291
09/11/2013,2013-09-11,1,0,0,1,3.2977881138337297
09/12/2013,2013-09-12,0,1,0,1,2.7232384811009775
09/13/2013,2013-09-13,4,1,0,5,3.2925051064435964
09/14/2013,2013-09-14,3,0,0,3,3.219371483382859
09/15/2013,2013-09-15,2,1,0,3,3.164524480401274
09/16/2013,2013-09-16,4,0,0,4,3.3734051629972854
09/17/2013,2013-09-17,1,2,0,3,3.2800499160050363
09/18/2013,2013-09-18,3,0,0,3,3.210035211672145
09/19/2013,2013-09-19,3,0,0,3,3.1575251570282745
09/20/2013,2013-09-20,6,0,0,6,3.868156572705162
09/23/2013,2013-09-23,3,0,0,3,3.6511145192596794
09/24/2013,2013-09-24,1,0,0,1,2.9883292240879946
09/25/2013,2013-09-25,1,1,0,2,2.7412450544487506
09/26/2013,2013-09-26,1,0,0,1,2.3059313283411864
09/27/2013,2013-09-27,0,2,0,2,2.2294481717667773
09/30/2013,2013-09-30,3,0,0,3,2.4220867417945398
10/01/2013,2013-10-01,3,0,0,3,2.5665654011405845
10/02/2013,2013-10-02,3,0,0,3,2.6749242448021753
10/03/2013,2013-10-03,1,1,1,3,2.7561932926965573
10/04/2013,2013-10-04,3,1,0,4,3.067145282587033
10/07/2013,2013-10-07,3,1,0,4,3.3003591380390174
10/08/2013,2013-10-08,3,2,0,5,3.7252695941652565
10/09/2013,2013-10-09,3,0,0,3,3.543952118610932
10/10/2013,2013-10-10,1,1,0,2,3.1579639659993837
10/11/2013,2013-10-11,3,1,0,4,3.36847302479372
10/12/2013,2013-10-12,1,0,0,1,2.7763546624949553
10/14/2013,2013-10-14,1,0,0,1,2.332265937189785
10/15/2013,2013-10-15,3,1,0,4,2.7491994949163594
10/16/2013,2013-10-16,2,0,0,2,2.5618996070283693
10/17/2013,2013-10-17,2,0,0,2,2.421424697306896
10/18/2013,2013-10-18,1,1,0,2,2.3160685185002077
10/21/2013,2013-10-21,2,2,0,4,2.737051402300958
10/22/2013,2013-10-22,4,1,0,5,3.3027885652574
10/23/2013,2013-10-23,1,0,0,1,2.7270914136156166
10/24/2013,2013-10-24,0,2,0,2,2.545318557766094
10/25/2013,2013-10-25,2,0,0,2,2.4089889169489105
10/27/2013,2013-10-27,1,0,0,1,2.05674168504587
10/28/2013,2013-10-28,1,0,0,1,1.7925562622848827
10/29/2013,2013-10-29,6,1,0,7,3.0944172022556966
10/31/2013,2013-10-31,1,1,0,2,2.82081290081822
11/01/2013,2013-11-01,4,2,0,6,3.61560967751686
11/03/2013,2013-11-03,0,0,1,1,2.9617072569632845
11/04/2013,2013-11-04,3,0,0,3,2.971280442735358
11/05/2013,2013-11-05,1,0,0,1,2.4784603315536673
11/06/2013,2013-11-06,4,0,0,4,2.8588452489534513
11/07/2013,2013-11-07,4,1,0,5,3.394133937019262
11/08/2013,2013-11-08,1,0,0,1,2.7956004525093623
11/10/2013,2013-11-10,1,0,0,1,2.3467003392385366
11/11/2013,2013-11-11,4,0,0,4,2.7600252545279877
11/12/2013,2013-11-12,1,2,0,3,2.820018940906777
11/14/2013,2013-11-14,1,0,0,1,2.365014205618727
11/15/2013,2013-11-15,4,1,0,5,3.0237606542806676
11/18/2013,2013-11-18,2,0,0,2,2.7678204906910873
11/19/2013,2013-11-19,6,1,0,7,3.8258653680785057
11/20/2013,2013-11-20,0,1,0,1,3.1193990260287374
11/21/2013,2013-11-21,1,0,0,1,2.589549269504598
11/22/2013,2013-11-22,0,1,0,1,2.1921619521189113
11/23/2013,2013-11-23,1,0,0,1,1.8941214640838189
11/25/2013,2013-11-25,1,1,0,2,1.9205910980632215
11/27/2013,2013-11-27,2,0,0,2,1.940443323547617
12/02/2013,2013-12-02,2,0,0,2,1.9553324926608258
12/04/2013,2013-12-04,2,0,0,2,1.966499369495683
12/09/2013,2013-12-09,3,0,0,3,2.224874527122866
12/10/2013,2013-12-10,1,1,0,2,2.1686558953419697
12/11/2013,2013-12-11,2,0,0,2,2.126491921506376
12/12/2013,2013-12-12,1,2,0,3,2.344868941130175
12/13/2013,2013-12-13,1,0,0,1,2.0086517058471767
12/16/2013,2013-12-16,0,1,0,1,1.756488779385127
12/18/2013,2013-12-18,2,0,0,2,1.8173665845388915
12/19/2013,2013-12-19,0,1,0,1,1.613024938404052
12/22/2013,2013-12-22,1,0,0,1,1.4597687038029736
12/26/2013,2013-12-26,0,2,0,2,1.5948265278522735
01/01/2014,2014-01-01,0,1,0,1,1.4461198958891694
01/03/2014,2014-01-03,0,1,0,1,1.3345899219168569
01/06/2014,2014-01-06,3,0,0,3,1.750942441437699
01/09/2014,2014-01-09,0,1,0,1,1.5632068310782552
01/13/2014,2014-01-13,0,1,0,1,1.4224051233086807
01/14/2014,2014-01-14,0,1,0,1,1.3168038424815045
01/17/2014,2014-01-17,1,1,0,2,1.4876028818611358
01/27/2014,2014-01-27,1,0,0,1,1.365702161395848
02/01/2014,2014-02-01,0,1,0,1,1.2742766210468839
02/04/2014,2014-02-04,1,0,0,1,1.2057074657851616
02/06/2014,2014-02-06,2,0,0,2,1.4042805993388738
02/07/2014,2014-02-07,1,1,0,2,1.5532104495041568
02/11/2014,2014-02-11,0,1,0,1,1.4149078371281165
02/12/2014,2014-02-12,0,1,0,1,1.3111808778460867
02/14/2014,2014-02-14,0,2,0,2,1.4833856583845657
02/15/2014,2014-02-15,0,1,0,1,1.3625392437884238
02/20/2014,2014-02-20,3,0,0,3,1.7719044328413187
02/21/2014,2014-02-21,2,1,0,3,2.0789283246309895
02/24/2014,2014-02-24,1,0,0,1,1.8091962434732418
02/26/2014,2014-02-26,0,1,0,1,1.6068971826049312
02/27/2014,2014-02-27,1,0,0,1,1.4551728869536982
02/28/2014,2014-02-28,2,0,0,2,1.5913796652152736
03/03/2014,2014-03-03,1,2,0,3,1.9435347489114554
03/04/2014,2014-03-04,0,1,0,1,1.7076510616835916
03/06/2014,2014-03-06,1,0,0,1,1.5307382962626939
03/07/2014,2014-03-07,0,1,0,1,1.3980537221970202
03/10/2014,2014-03-10,1,2,0,3,1.7985402916477653
03/12/2014,2014-03-12,0,4,0,4,2.348905218735824
03/14/2014,2014-03-14,0,1,0,1,2.011678914051868
03/18/2014,2014-03-18,2,0,0,2,2.0087591855389006
03/25/2014,2014-03-25,0,3,0,3,2.2565693891541754
03/26/2014,2014-03-26,1,1,0,2,2.1924270418656313
03/31/2014,2014-03-31,0,1,0,1,1.8943202813992235
04/01/2014,2014-04-01,1,0,0,1,1.6707402110494176
04/02/2014,2014-04-02,0,2,0,2,1.7530551582870633
04/07/2014,2014-04-07,0,1,0,1,1.5647913687152974
04/09/2014,2014-04-09,0,2,0,2,1.6735935265364732
04/15/2014,2014-04-15,0,1,0,1,1.505195144902355
04/17/2014,2014-04-17,0,1,0,1,1.3788963586767662
04/22/2014,2014-04-22,0,1,0,1,1.2841722690075745
04/25/2014,2014-04-25,1,1,0,2,1.4631292017556807
04/28/2014,2014-04-28,0,1,0,1,1.3473469013167605
05/16/2014,2014-05-16,1,0,0,1,1.2605101759875703
05/19/2014,2014-05-19,0,1,0,1,1.1953826319906777
05/21/2014,2014-05-21,1,0,0,1,1.1465369739930082
05/30/2014,2014-05-30,1,0,0,1,1.1099027304947562
06/01/2014,2014-06-01,0,1,0,1,1.0824270478710671
06/11/2014,2014-06-11,0,1,0,1,1.0618202859033004
06/13/2014,2014-06-13,0,1,0,1,1.0463652144274753
06/24/2014,2014-06-24,0,1,0,1,1.0347739108206064
07/01/2014,2014-07-01,2,0,0,2,1.2760804331154547
07/09/2014,2014-07-09,0,1,0,1,1.207060324836591
08/11/2014,2014-08-11,3,0,0,3,1.6552952436274435
08/14/2014,2014-08-14,1,0,0,1,1.4914714327205825
08/18/2014,2014-08-18,0,1,0,1,1.3686035745404368
08/20/2014,2014-08-20,2,0,0,2,1.5264526809053278
08/21/2014,2014-08-21,2,0,0,2,1.644839510678996
08/23/2014,2014-08-23,1,0,0,1,1.4836296330092469
08/26/2014,2014-08-26,0,2,0,2,1.6127222247569353
08/27/2014,2014-08-27,2,0,0,2,1.7095416685677016
08/28/2014,2014-08-28,1,0,0,1,1.5321562514257763
09/01/2014,2014-09-01,6,2,0,8,3.1491171885693325
09/02/2014,2014-09-02,2,0,0,2,2.8618378914269993
09/03/2014,2014-09-03,8,5,0,13,5.39637841857025
09/04/2014,2014-09-04,0,2,0,2,4.547283813927687
09/05/2014,2014-09-05,3,0,0,3,4.160462860445765
09/09/2014,2014-09-09,6,1,1,8,5.120347145334324
09/10/2014,2014-09-10,1,0,0,1,4.090260359000743
09/12/2014,2014-09-12,7,0,0,7,4.817695269250557
09/15/2014,2014-09-15,3,1,0,4,4.613271451937917
09/16/2014,2014-09-16,4,0,0,4,4.459953588953438
09/17/2014,2014-09-17,2,1,0,3,4.094965191715078
09/18/2014,2014-09-18,0,2,0,2,3.5712238937863083
09/19/2014,2014-09-19,1,1,0,2,3.178417920339731
09/22/2014,2014-09-22,5,0,0,5,3.6338134402547984
09/23/2014,2014-09-23,1,0,0,1,2.9753600801910984
09/24/2014,2014-09-24,3,2,0,5,3.4815200601433243
09/25/2014,2014-09-25,1,0,0,1,2.861140045107493
09/26/2014,2014-09-26,2,1,0,3,2.8958550338306197
09/29/2014,2014-09-29,5,0,0,5,3.421891275372965
09/30/2014,2014-09-30,1,2,0,3,3.316418456529724
10/01/2014,2014-10-01,3,1,0,4,3.487313842397293
10/02/2014,2014-10-02,1,0,0,1,2.8654853817979697
10/03/2014,2014-10-03,4,1,0,5,3.3991140363484775
10/06/2014,2014-10-06,5,1,0,6,4.049335527261358
10/07/2014,2014-10-07,0,1,0,1,3.2870016454460185
10/08/2014,2014-10-08,1,1,0,2,2.9652512340845134
10/09/2014,2014-10-09,4,0,0,4,3.2239384255633854
10/10/2014,2014-10-10,6,0,0,6,3.9179538191725394
10/13/2014,2014-10-13,2,2,0,4,3.9384653643794048
10/15/2014,2014-10-15,2,1,0,3,3.703849023284554
10/16/2014,2014-10-16,3,1,0,4,3.7778867674634156
10/17/2014,2014-10-17,5,1,0,6,4.333415075597562
10/19/2014,2014-10-19,1,0,0,1,3.500061306698171
10/20/2014,2014-10-20,2,1,0,3,3.375045980023628
10/21/2014,2014-10-21,0,2,0,2,3.0312844850177214
10/22/2014,2014-10-22,1,0,0,1,2.5234633637632906
10/23/2014,2014-10-23,1,2,0,3,2.642597522822468
10/24/2014,2014-10-24,3,2,0,5,3.231948142116851
10/27/2014,2014-10-27,1,3,0,4,3.4239611065876385
10/28/2014,2014-10-28,3,0,0,3,3.317970829940729
10/29/2014,2014-10-29,3,0,0,3,3.238478122455547
10/30/2014,2014-10-30,0,1,0,1,2.6788585918416596
10/31/2014,2014-10-31,5,2,0,7,3.759143943881245
11/01/2014,2014-11-01,1,0,0,1,3.069357957910934
11/03/2014,2014-11-03,3,0,0,3,3.0520184684332006
11/04/2014,2014-11-04,2,0,0,2,2.7890138513249
11/05/2014,2014-11-05,1,0,0,1,2.341760388493675
11/06/2014,2014-11-06,2,0,0,2,2.256320291370256
11/07/2014,2014-11-07,3,0,0,3,2.442240218527692
11/10/2014,2014-11-10,1,0,0,1,2.081680163895769
11/12/2014,2014-11-12,1,0,0,1,1.8112601229218266
11/13/2014,2014-11-13,3,1,0,4,2.3584450921913698
11/14/2014,2014-11-14,1,0,0,1,2.018833819143527
11/15/2014,2014-11-15,0,1,0,1,1.7641253643576453
11/16/2014,2014-11-16,1,0,0,1,1.573094023268234
11/17/2014,2014-11-17,5,1,0,6,2.6798205174511756
11/18/2014,2014-11-18,1,1,0,2,2.5098653880883814
11/20/2014,2014-11-20,2,2,0,4,2.882399041066286
11/21/2014,2014-11-21,7,3,0,10,4.661799280799714
11/24/2014,2014-11-24,2,0,0,2,3.996349460599786
11/25/2014,2014-11-25,1,1,0,2,3.4972620954498392
11/27/2014,2014-11-27,1,0,0,1,2.872946571587379
12/01/2014,2014-12-01,5,1,0,6,3.6547099286905347
12/02/2014,2014-12-02,1,0,0,1,2.9910324465179006
12/05/2014,2014-12-05,0,2,0,2,2.7432743348884254
12/10/2014,2014-12-10,1,1,0,2,2.557455751166319
12/11/2014,2014-12-11,2,1,0,3,2.668091813374739
12/15/2014,2014-12-15,1,0,0,1,2.251068860031054
12/17/2014,2014-12-17,3,1,0,4,2.6883016450232904
12/18/2014,2014-12-18,1,1,0,2,2.5162262337674677
12/19/2014,2014-12-19,1,1,0,2,2.3871696753256004
12/26/2014,2014-12-26,0,2,0,2,2.2903772564942004
12/30/2014,2014-12-30,2,1,0,3,2.46778294237065
01/01/2015,2015-01-01,0,1,0,1,2.1008372067779875
01/04/2015,2015-01-04,1,0,0,1,1.8256279050834905
01/05/2015,2015-01-05,0,1,0,1,1.6192209288126178
01/06/2015,2015-01-06,0,1,0,1,1.4644156966094632
01/07/2015,2015-01-07,1,1,0,2,1.5983117724570977
01/13/2015,2015-01-13,1,0,0,1,1.4487338293428231
01/14/2015,2015-01-14,0,2,0,2,1.5865503720071175
01/15/2015,2015-01-15,5,1,0,6,2.689912779005338
01/16/2015,2015-01-16,1,0,0,1,2.2674345842540036
01/20/2015,2015-01-20,0,2,0,2,2.200575938190503
01/22/2015,2015-01-22,2,1,0,3,2.400431953642877
01/28/2015,2015-01-28,3,0,0,3,2.5503239652321574
02/02/2015,2015-02-02,1,0,0,1,2.162742973924118
02/06/2015,2015-02-06,0,1,0,1,1.8720572304430885
02/09/2015,2015-02-09,0,1,0,1,1.6540429228323164
02/10/2015,2015-02-10,0,2,0,2,1.7405321921242374
02/12/2015,2015-02-12,1,0,0,1,1.555399144093178
02/17/2015,2015-02-17,2,1,0,3,1.9165493580698836
02/24/2015,2015-02-24,0,1,0,1,1.6874120185524126
02/25/2015,2015-02-25,1,2,0,3,2.0155590139143094
02/26/2015,2015-02-26,0,1,0,1,1.761669260435732
02/27/2015,2015-02-27,0,2,0,2,1.821251945326799
03/02/2015,2015-03-02,0,2,0,2,1.8659389589950992
03/03/2015,2015-03-03,1,1,0,2,1.8994542192463244
03/05/2015,2015-03-05,0,2,0,2,1.9245906644347432
03/09/2015,2015-03-09,0,3,0,3,2.1934429983260575
03/10/2015,2015-03-10,1,0,0,1,1.8950822487445431
03/13/2015,2015-03-13,1,7,0,8,3.4213116865584077
03/15/2015,2015-03-15,1,0,0,1,2.8159837649188053
03/16/2015,2015-03-16,0,4,0,4,3.111987823689104
03/20/2015,2015-03-20,0,1,0,1,2.5839908677668277
03/30/2015,2015-03-30,0,1,0,1,2.1879931508251205
03/31/2015,2015-03-31,0,1,0,1,1.8909948631188402
04/01/2015,2015-04-01,0,4,0,4,2.41824614733913
04/02/2015,2015-04-02,0,1,0,1,2.0636846105043474
04/08/2015,2015-04-08,0,2,0,2,2.0477634578782604
04/09/2015,2015-04-09,1,1,1,3,2.285822593408695
04/11/2015,2015-04-11,1,0,0,1,1.9643669450565213
04/12/2015,2015-04-12,0,1,0,1,1.723275208792391
04/13/2015,2015-04-13,1,0,0,1,1.5424564065942934
04/16/2015,2015-04-16,1,2,0,3,1.9068423049457202
04/21/2015,2015-04-21,0,2,0,2,1.93013172870929
04/22/2015,2015-04-22,0,1,0,1,1.6975987965319677
04/28/2015,2015-04-28,0,5,0,5,2.523199097398976
05/01/2015,2015-05-01,0,6,0,6,3.3923993230492324
05/04/2015,2015-05-04,0,2,0,2,3.0442994922869246
05/11/2015,2015-05-11,0,1,0,1,2.533224619215193
05/27/2015,2015-05-27,0,2,0,2,2.3999184644113947
06/01/2015,2015-06-01,0,3,0,3,2.549938848308546
06/04/2015,2015-06-04,0,1,0,1,2.1624541362314096
06/08/2015,2015-06-08,1,4,0,5,2.871840602173557
06/17/2015,2015-06-17,1,0,0,1,2.4038804516301675
06/18/2015,2015-06-18,0,1,0,1,2.0529103387226257
06/19/2015,2015-06-19,1,0,0,1,1.7896827540419693
06/23/2015,2015-06-23,0,1,0,1,1.592262065531477
06/24/2015,2015-06-24,0,1,0,1,1.4441965491486075
06/30/2015,2015-06-30,0,2,0,2,1.5831474118614557
08/01/2015,2015-08-01,1,0,0,1,1.4373605588960916
08/10/2015,2015-08-10,2,0,0,2,1.5780204191720688
08/12/2015,2015-08-12,1,0,0,1,1.4335153143790516
08/13/2015,2015-08-13,0,1,0,1,1.3251364857842887
08/14/2015,2015-08-14,2,0,0,2,1.4938523643382164
08/17/2015,2015-08-17,2,0,0,2,1.6203892732536624
08/18/2015,2015-08-18,1,0,0,1,1.4652919549402468
08/20/2015,2015-08-20,3,0,0,3,1.8489689662051851
08/25/2015,2015-08-25,2,1,0,3,2.136726724653889
08/26/2015,2015-08-26,1,0,0,1,1.8525450434904165
08/27/2015,2015-08-27,1,0,0,1,1.6394087826178123
08/28/2015,2015-08-28,3,0,0,3,1.9795565869633593
08/31/2015,2015-08-31,1,1,0,2,1.9846674402225195
09/01/2015,2015-09-01,4,4,0,8,3.4885005801668902
09/02/2015,2015-09-02,2,0,0,2,3.116375435125168
09/04/2015,2015-09-04,3,0,0,3,3.087281576343876
09/08/2015,2015-09-08,1,1,0,2,2.815461182257907
09/09/2015,2015-09-09,1,0,0,1,2.36159588669343
09/11/2015,2015-09-11,5,1,0,6,3.271196915020073
09/12/2015,2015-09-12,1,0,0,1,2.7033976862650544
09/14/2015,2015-09-14,2,0,0,2,2.527548264698791
09/15/2015,2015-09-15,5,0,0,5,3.145661198524093
09/16/2015,2015-09-16,1,0,0,1,2.60924589889307
09/17/2015,2015-09-17,2,0,0,2,2.4569344241698023
09/18/2015,2015-09-18,2,1,0,3,2.592700818127352
09/21/2015,2015-09-21,1,0,0,1,2.1945256135955136
09/22/2015,2015-09-22,4,0,0,4,2.645894210196635
09/23/2015,2015-09-23,5,0,0,5,3.2344206576474765
09/24/2015,2015-09-24,3,0,0,3,3.1758154932356075
09/25/2015,2015-09-25,7,2,0,9,4.631861619926706
09/26/2015,2015-09-26,2,0,0,2,3.9738962149450296
09/28/2015,2015-09-28,2,0,0,2,3.4804221612087725
09/29/2015,2015-09-29,3,0,0,3,3.3603166209065796
09/30/2015,2015-09-30,1,0,0,1,2.7702374656799345
10/01/2015,2015-10-01,5,0,0,5,3.327678099259951
10/02/2015,2015-10-02,4,2,0,6,3.9957585744449635
10/05/2015,2015-10-05,1,0,0,1,3.2468189308337227
10/06/2015,2015-10-06,2,0,0,2,2.9351141981252917
10/07/2015,2015-10-07,1,0,0,1,2.4513356485939686
10/08/2015,2015-10-08,3,3,0,6,3.338501736445477
10/09/2015,2015-10-09,1,3,0,4,3.503876302334108
10/12/2015,2015-10-12,2,0,0,2,3.127907226750581
10/13/2015,2015-10-13,5,0,0,5,3.595930420062936
10/14/2015,2015-10-14,2,0,0,2,3.196947815047202
10/15/2015,2015-10-15,2,2,0,4,3.3977108612854017
10/16/2015,2015-10-16,1,1,0,2,3.0482831459640516
10/19/2015,2015-10-19,2,1,0,3,3.036212359473039
10/20/2015,2015-10-20,3,0,0,3,3.027159269604779
10/21/2015,2015-10-21,3,0,0,3,3.0203694522035844
10/22/2015,2015-10-22,0,0,1,1,2.515277089152688
10/23/2015,2015-10-23,1,0,0,1,2.136457816864516
10/26/2015,2015-10-26,1,1,1,3,2.352343362648387
10/27/2015,2015-10-27,2,1,0,3,2.5142575219862904
10/28/2015,2015-10-28,2,1,0,3,2.6356931414897176
10/29/2015,2015-10-29,3,0,0,3,2.726769856117288
10/30/2015,2015-10-30,1,0,0,1,2.295077392087966
11/01/2015,2015-11-01,4,3,0,7,3.471308044065975
11/02/2015,2015-11-02,4,1,0,5,3.8534810330494813
11/03/2015,2015-11-03,1,0,0,1,3.140110774787111
11/04/2015,2015-11-04,3,0,0,3,3.105083081090333
11/05/2015,2015-11-05,1,2,0,3,3.07881231081775
11/06/2015,2015-11-06,3,0,0,3,3.0591092331133125
11/09/2015,2015-11-09,1,0,0,1,2.5443319248349843
11/10/2015,2015-11-10,0,1,0,1,2.158248943626238
11/11/2015,2015-11-11,1,0,0,1,1.8686867077196785
11/12/2015,2015-11-12,2,1,0,3,2.151515030789759
11/13/2015,2015-11-13,1,0,0,1,1.8636362730923193
11/15/2015,2015-11-15,1,0,0,1,1.6477272048192395
11/19/2015,2015-11-19,3,0,0,3,1.9857954036144296
11/20/2015,2015-11-20,1,0,0,1,1.7393465527108223
11/21/2015,2015-11-21,0,1,0,1,1.5545099145331167
11/24/2015,2015-11-24,0,1,0,1,1.4158824358998374
11/25/2015,2015-11-25,2,1,0,3,1.8119118269248782
12/01/2015,2015-12-01,1,0,0,1,1.6089338701936586
12/04/2015,2015-12-04,1,1,0,2,1.7067004026452441
12/07/2015,2015-12-07,2,0,0,2,1.7800253019839332
12/11/2015,2015-12-11,1,0,0,1,1.5850189764879499
12/15/2015,2015-12-15,1,0,0,1,1.4387642323659622
12/16/2015,2015-12-16,0,1,0,1,1.3290731742744715
12/29/2015,2015-12-29,2,0,0,2,1.4968048807058536
01/01/2016,2016-01-01,0,2,0,2,1.6226036605293903
01/04/2016,2016-01-04,4,5,0,9,3.4669527453970432
01/06/2016,2016-01-06,0,1,0,1,2.850214559047782
01/07/2016,2016-01-07,1,0,0,1,2.3876609192858362
01/08/2016,2016-01-08,0,1,0,1,2.040745689464377
01/11/2016,2016-01-11,1,0,0,1,1.7805592670982826
01/12/2016,2016-01-12,0,3,0,3,2.085419450323712
01/14/2016,2016-01-14,1,0,0,1,1.814064587742784
01/20/2016,2016-01-20,0,1,0,1,1.610548440807088
01/25/2016,2016-01-25,0,4,0,4,2.207911330605316
01/26/2016,2016-01-26,1,1,0,2,2.155933497953987
01/27/2016,2016-01-27,1,0,0,1,1.8669501234654902
01/28/2016,2016-01-28,1,0,0,1,1.6502125925991176
01/29/2016,2016-01-29,3,1,0,4,2.237659444449338
02/01/2016,2016-02-01,2,0,0,2,2.1782445833370034
02/02/2016,2016-02-02,0,2,0,2,2.1336834375027527
02/08/2016,2016-02-08,0,1,0,1,1.8502625781270645
02/12/2016,2016-02-12,0,1,0,1,1.6376969335952984
02/17/2016,2016-02-17,0,1,0,1,1.4782727001964737
02/24/2016,2016-02-24,1,1,0,2,1.6087045251473555
02/26/2016,2016-02-26,1,0,0,1,1.4565283938605165
02/29/2016,2016-02-29,0,5,0,5,2.3423962953953876
03/01/2016,2016-03-01,1,0,0,1,2.006797221546541
03/04/2016,2016-03-04,2,2,0,4,2.5050979161599054
03/08/2016,2016-03-08,0,1,0,1,2.128823437119929
03/09/2016,2016-03-09,1,0,0,1,1.8466175778399465
03/15/2016,2016-03-15,0,2,0,2,1.8849631833799598
03/29/2016,2016-03-29,0,2,0,2,1.9137223875349698
03/30/2016,2016-03-30,0,1,0,1,1.6852917906512275
03/31/2016,2016-03-31,1,0,0,1,1.5139688429884206
04/01/2016,2016-04-01,0,1,0,1,1.3854766322413152
04/07/2016,2016-04-07,0,1,0,1,1.2891074741809863
04/11/2016,2016-04-11,0,1,0,1,1.2168306056357396
04/12/2016,2016-04-12,0,1,0,1,1.1626229542268047
04/15/2016,2016-04-15,0,1,0,1,1.1219672156701035
04/21/2016,2016-04-21,0,2,0,2,1.3414754117525776
05/03/2016,2016-05-03,0,2,0,2,1.5061065588144333
05/12/2016,2016-05-12,0,1,0,1,1.379579919110825
05/20/2016,2016-05-20,0,2,0,2,1.5346849393331188
05/24/2016,2016-05-24,0,2,0,2,1.6510137044998392
06/13/2016,2016-06-13,0,2,0,2,1.7382602783748795
06/15/2016,2016-06-15,0,1,0,1,1.5536952087811597
06/16/2016,2016-06-16,0,2,0,2,1.6652714065858698
06/24/2016,2016-06-24,0,1,0,1,1.4989535549394022
07/07/2016,2016-07-07,0,1,0,1,1.3742151662045516
08/01/2016,2016-08-01,1,0,0,1,1.2806613746534137
08/26/2016,2016-08-26,1,0,0,1,1.21049603099006
08/29/2016,2016-08-29,0,0,1,1,1.157872023242545
09/01/2016,2016-09-01,0,1,0,1,1.1184040174319088
09/11/2016,2016-09-11,20,9,0,29,8.088803013073933
09/12/2016,2016-09-12,1,0,0,1,6.31660225980545
09/13/2016,2016-09-13,1,0,0,1,4.987451694854086
09/14/2016,2016-09-14,0,1,0,1,3.9905887711405645
09/15/2016,2016-09-15,7,6,1,14,6.492941578355424
09/19/2016,2016-09-19,1,0,0,1,5.119706183766567
09/21/2016,2016-09-21,1,0,0,1,4.089779637824925
09/22/2016,2016-09-22,1,0,0,1,3.317334728368694
09/23/2016,2016-09-23,9,1,0,10,4.988001046276521
09/28/2016,2016-09-28,2,0,0,2,4.24100078470739
09/29/2016,2016-09-29,1,0,2,3,3.9307505885305427
09/30/2016,2016-09-30,8,3,0,11,5.698062941397907
10/03/2016,2016-10-03,3,0,0,3,5.0235472060484305
10/05/2016,2016-10-05,1,0,0,1,4.017660404536323
10/07/2016,2016-10-07,4,4,0,8,5.013245303402242
10/10/2016,2016-10-10,3,0,0,3,4.509933977551682
10/11/2016,2016-10-11,2,0,0,2,3.882450483163761
10/12/2016,2016-10-12,2,0,0,2,3.411837862372821
10/14/2016,2016-10-14,5,3,0,8,4.558878396779616
10/17/2016,2016-10-17,0,0,1,1,3.669158797584712
10/18/2016,2016-10-18,1,1,0,2,3.251869098188534
10/21/2016,2016-10-21,4,6,0,10,4.938901823641401
10/24/2016,2016-10-24,3,0,0,3,4.45417636773105
10/26/2016,2016-10-26,2,0,0,2,3.8406322757982876
10/28/2016,2016-10-28,6,4,0,10,5.3804742068487155
11/03/2016,2016-11-03,0,1,0,1,4.285355655136536
11/04/2016,2016-11-04,9,0,0,9,5.464016741352402
11/05/2016,2016-11-05,1,0,0,1,4.348012556014301
11/10/2016,2016-11-10,0,1,0,1,3.5110094170107256
11/11/2016,2016-11-11,1,1,0,2,3.133257062758044
11/14/2016,2016-11-14,4,0,0,4,3.3499427970685334
11/15/2016,2016-11-15,0,2,0,2,3.0124570978014003
11/18/2016,2016-11-18,1,3,0,4,3.25934282335105
11/22/2016,2016-11-22,0,2,0,2,2.9445071175132873
11/23/2016,2016-11-23,1,0,0,1,2.4583803381349654
11/30/2016,2016-11-30,2,1,0,3,2.593785253601224
12/02/2016,2016-12-02,0,1,0,1,2.195338940200918
12/09/2016,2016-12-09,1,4,0,5,2.8965042051506886
12/14/2016,2016-12-14,1,0,0,1,2.4223781538630162
12/16/2016,2016-12-16,2,1,0,3,2.566783615397262
12/18/2016,2016-12-18,1,0,0,1,2.1750877115479463
12/20/2016,2016-12-20,1,0,0,1,1.8813157836609598
12/23/2016,2016-12-23,0,4,0,4,2.4109868377457198
12/30/2016,2016-12-30,1,0,0,1,2.05824012830929
01/06/2017,2017-01-06,0,2,0,2,2.0436800962319674
01/13/2017,2017-01-13,1,0,0,1,1.7827600721739756
01/20/2017,2017-01-20,0,7,0,7,3.087070054130482
01/23/2017,2017-01-23,0,1,0,1,2.565302540597861
01/26/2017,2017-01-26,0,1,0,1,2.1739769054483955
01/27/2017,2017-01-27,0,5,0,5,2.8804826790862967
02/03/2017,2017-02-03,0,3,0,3,2.9103620093147224
02/09/2017,2017-02-09,1,0,0,1,2.432771506986042
02/10/2017,2017-02-10,1,3,0,4,2.8245786302395315
02/16/2017,2017-02-16,0,1,0,1,2.3684339726796484
02/17/2017,2017-02-17,0,5,0,5,3.0263254795097367
02/24/2017,2017-02-24,1,2,0,3,3.0197441096323026
02/28/2017,2017-02-28,2,0,0,2,2.7648080822242265
03/03/2017,2017-03-03,0,1,0,1,2.3236060616681695
03/10/2017,2017-03-10,0,4,1,5,2.9927045462511273
03/17/2017,2017-03-17,0,2,0,2,2.7445284096883453
03/21/2017,2017-03-21,0,1,0,1,2.3083963072662588
03/23/2017,2017-03-23,0,1,0,1,1.981297230449694
03/24/2017,2017-03-24,1,1,0,2,1.9859729228372707
03/31/2017,2017-03-31,0,2,1,3,2.239479692127953
04/07/2017,2017-04-07,1,1,0,2,2.179609769095965
04/14/2017,2017-04-14,0,3,0,3,2.3847073268219736
04/21/2017,2017-04-21,0,2,0,2,2.28853049511648
05/02/2017,2017-05-02,0,1,0,1,1.96639787133736
05/05/2017,2017-05-05,0,1,0,1,1.72479840350302
05/07/2017,2017-05-07,1,0,0,1,1.5435988026272651
05/19/2017,2017-05-19,0,1,0,1,1.4076991019704488
05/22/2017,2017-05-22,0,1,0,1,1.3057743264778365
05/26/2017,2017-05-26,0,2,0,2,1.4793307448583772
06/02/2017,2017-06-02,0,1,0,1,1.3594980586437828
06/07/2017,2017-06-07,0,1,0,1,1.269623543982837
06/15/2017,2017-06-15,0,3,0,3,1.7022176579871278
06/23/2017,2017-06-23,0,1,0,1,1.526663243490346
06/27/2017,2017-06-27,0,1,0,1,1.3949974326177594
08/03/2017,2017-08-03,1,0,0,1,1.2962480744633196
08/21/2017,2017-08-21,1,0,0,1,1.2221860558474895
08/24/2017,2017-08-24,2,0,0,2,1.416639541885617
09/01/2017,2017-09-01,1,0,0,1,1.3124796564142127
09/10/2017,2017-09-10,25,3,0,28,7.984359742310661
09/11/2017,2017-09-11,1,0,0,1,6.238269806732996
09/15/2017,2017-09-15,5,2,0,7,6.428702355049747
09/19/2017,2017-09-19,1,0,0,1,5.07152676628731
09/22/2017,2017-09-22,13,3,0,16,7.803645074715483
09/24/2017,2017-09-24,2,0,0,2,6.352733806036612
09/27/2017,2017-09-27,1,0,0,1,5.014550354527459
09/29/2017,2017-09-29,12,4,2,18,8.260912765895595
10/03/2017,2017-10-03,1,0,0,1,6.445684574421696
10/05/2017,2017-10-05,0,1,0,1,5.0842634308162715
10/06/2017,2017-10-06,12,6,0,18,8.313197573112204
10/09/2017,2017-10-09,1,0,0,1,6.484898179834152
10/13/2017,2017-10-13,6,1,0,7,6.613673634875615
10/18/2017,2017-10-18,0,1,0,1,5.21025522615671
10/20/2017,2017-10-20,9,4,1,14,7.407691419617533
10/27/2017,2017-10-27,8,3,0,11,8.30576856471315
10/31/2017,2017-10-31,0,2,0,2,6.729326423534862
11/01/2017,2017-11-01,3,1,0,4,6.0469948176511465
11/03/2017,2017-11-03,7,3,0,10,7.03524611323836
11/05/2017,2017-11-05,0,1,0,1,5.5264345849287695
11/07/2017,2017-11-07,1,0,0,1,4.3948259386965765
11/09/2017,2017-11-09,0,3,0,3,4.046119454022432
11/10/2017,2017-11-10,5,2,0,7,4.784589590516824
11/15/2017,2017-11-15,0,1,0,1,3.838442192887618
11/16/2017,2017-11-16,1,0,0,1,3.1288316446657136
11/17/2017,2017-11-17,4,1,0,5,3.5966237334992854
11/18/2017,2017-11-18,1,0,0,1,2.9474678001244636
11/20/2017,2017-11-20,1,1,0,2,2.7106008500933476
11/21/2017,2017-11-21,2,0,0,2,2.5329506375700106
11/22/2017,2017-11-22,1,3,0,4,2.899712978177508
11/29/2017,2017-11-29,0,1,0,1,2.424784733633131
12/01/2017,2017-12-01,1,1,0,2,2.318588550224848
12/08/2017,2017-12-08,4,2,0,6,3.238941412668636
12/15/2017,2017-12-15,2,5,0,7,4.179206059501477
12/22/2017,2017-12-22,1,2,0,3,3.8844045446261077
12/27/2017,2017-12-27,1,0,0,1,3.163303408469581
12/29/2017,2017-12-29,4,0,0,4,3.3724775563521856
01/08/2018,2018-01-08,1,2,0,3,3.279358167264139
01/10/2018,2018-01-10,1,0,0,1,2.709518625448104
01/12/2018,2018-01-12,1,2,0,3,2.782138969086078
01/17/2018,2018-01-17,2,0,0,2,2.586604226814558
01/19/2018,2018-01-19,1,4,0,5,3.1899531701109187
01/20/2018,2018-01-20,0,2,0,2,2.8924648775831887
01/24/2018,2018-01-24,2,0,0,2,2.6693486581873915
01/25/2018,2018-01-25,1,0,0,1,2.2520114936405435
01/26/2018,2018-01-26,0,5,0,5,2.9390086202304078
02/02/2018,2018-02-02,1,2,0,3,2.9542564651728056
02/09/2018,2018-02-09,0,3,0,3,2.965692348879604
02/15/2018,2018-02-15,1,0,0,1,2.474269261659703
02/16/2018,2018-02-16,1,1,0,2,2.355701946244777
02/23/2018,2018-02-23,1,1,0,2,2.266776459683583
03/02/2018,2018-03-02,1,2,0,3,2.450082344762687
03/09/2018,2018-03-09,1,4,0,5,3.0875617585720154
03/16/2018,2018-03-16,1,4,0,5,3.5656713189290117
03/23/2018,2018-03-23,0,2,0,2,3.174253489196759
03/30/2018,2018-03-30,0,3,0,3,3.1306901168975694
04/06/2018,2018-04-06,0,2,0,2,2.848017587673177
04/11/2018,2018-04-11,1,0,0,1,2.3860131907548823
04/13/2018,2018-04-13,0,5,0,5,3.039509893066162
04/20/2018,2018-04-20,0,1,0,1,2.529632419799621
04/27/2018,2018-04-27,1,1,0,2,2.3972243148497157
05/04/2018,2018-05-04,3,2,0,5,3.047918236137287
05/11/2018,2018-05-11,0,2,0,2,2.785938677102965
05/18/2018,2018-05-18,0,2,0,2,2.5894540078272237
05/25/2018,2018-05-25,0,5,0,5,3.192090505870418
06/01/2018,2018-06-01,0,1,0,1,2.644067879402813
06/08/2018,2018-06-08,0,1,0,1,2.2330509095521096
06/15/2018,2018-06-15,1,0,0,1,1.9247881821640822
06/29/2018,2018-06-29,0,1,0,1,1.6935911366230616
07/06/2018,2018-07-06,2,0,0,2,1.7701933524672964
08/12/2018,2018-08-12,1,0,0,1,1.5776450143504723
08/13/2018,2018-08-13,1,0,0,1,1.433233760762854
08/19/2018,2018-08-19,1,0,0,1,1.3249253205721405
09/06/2018,2018-09-06,1,0,0,1,1.2436939904291053
09/09/2018,2018-09-09,3,0,0,3,1.6827704928218292
09/10/2018,2018-09-10,15,3,4,22,6.762077869616373
09/11/2018,2018-09-11,1,0,1,2,5.571558402212279
09/14/2018,2018-09-14,5,1,1,7,5.928668801659209
09/21/2018,2018-09-21,10,0,1,11,7.196501601244408
09/24/2018,2018-09-24,1,0,0,1,5.647376200933305
09/25/2018,2018-09-25,1,0,0,1,4.485532150699979
09/28/2018,2018-09-28,6,5,1,12,6.364149113024985
10/02/2018,2018-10-02,0,0,1,1,5.023111834768739
10/03/2018,2018-10-03,1,0,0,1,4.017333876076553
10/05/2018,2018-10-05,9,4,0,13,6.263000407057416
10/12/2018,2018-10-12,7,3,3,13,7.947250305293062
10/19/2018,2018-10-19,7,1,0,8,7.960437728969797
10/25/2018,2018-10-25,1,0,0,1,6.220328296727348
10/26/2018,2018-10-26,4,3,1,8,6.665246222545512
11/01/2018,2018-11-01,0,1,0,1,5.2489346669091335
11/02/2018,2018-11-02,3,1,0,4,4.936701000181849
11/09/2018,2018-11-09,2,3,0,5,4.952525750136387
11/15/2018,2018-11-15,0,1,0,1,3.9643943126022902
11/16/2018,2018-11-16,2,1,0,3,3.723295734451718
11/21/2018,2018-11-21,1,0,1,2,3.2924718008387885
11/30/2018,2018-11-30,3,2,1,6,3.9693538506290915
12/03/2018,2018-12-03,0,1,0,1,3.227015387971819
12/07/2018,2018-12-07,1,5,4,10,4.920261540978864
12/14/2018,2018-12-14,1,2,1,4,4.6901961557341485
12/21/2018,2018-12-21,2,2,0,4,4.517647116800611
12/28/2018,2018-12-28,1,0,1,2,3.888235337600458
01/03/2019,2019-01-03,0,2,0,2,3.4161765032003437
01/07/2019,2019-01-07,1,0,0,1,2.8121323774002573
01/11/2019,2019-01-11,2,3,0,5,3.359099283050193
01/18/2019,2019-01-18,1,6,0,7,4.269324462287645
01/25/2019,2019-01-25,0,1,0,1,3.4519933467157333
01/28/2019,2019-01-28,0,0,1,1,2.8389950100367995
02/01/2019,2019-02-01,2,1,1,4,3.1292462575276
02/08/2019,2019-02-08,1,2,3,6,3.8469346931457
02/10/2019,2019-02-10,1,0,0,1,3.135201019859275
02/15/2019,2019-02-15,0,1,0,1,2.601400764894456
02/22/2019,2019-02-22,2,5,1,8,3.9510505736708423
03/01/2019,2019-03-01,0,3,1,4,3.9632879302531316
03/08/2019,2019-03-08,1,3,0,4,3.972465947689849
03/15/2019,2019-03-15,1,1,0,2,3.479349460767387
03/21/2019,2019-03-21,0,1,0,1,2.85951209557554
03/22/2019,2019-03-22,1,0,0,1,2.3946340716816548
03/23/2019,2019-03-23,0,0,1,1,2.045975553761241
03/29/2019,2019-03-29,0,1,0,1,1.7844816653209308
04/12/2019,2019-04-12,0,2,0,2,1.8383612489906982
04/15/2019,2019-04-15,0,1,0,1,1.6287709367430236
04/19/2019,2019-04-19,0,2,0,2,1.721578202557268
05/10/2019,2019-05-10,0,5,0,5,2.541183651917951
05/20/2019,2019-05-20,0,1,0,1,2.155887738938463
05/24/2019,2019-05-24,0,1,0,1,1.8669158042038474
05/31/2019,2019-05-31,0,2,0,2,1.9001868531528856
06/14/2019,2019-06-14,0,0,1,1,1.6751401398646641
06/21/2019,2019-06-21,1,0,0,1,1.5063551048984982
07/02/2019,2019-07-02,0,1,0,1,1.3797663286738735
08/20/2019,2019-08-20,1,0,0,1,1.284824746505405
08/29/2019,2019-08-29,2,0,0,2,1.4636185598790536
09/02/2019,2019-09-02,1,0,0,1,1.3477139199092902
09/03/2019,2019-09-03,1,0,0,1,1.2607854399319676
09/09/2019,2019-09-09,1,1,0,2,1.4455890799489757
09/10/2019,2019-09-10,1,0,0,1,1.3341918099617316
09/11/2019,2019-09-11,1,1,0,2,1.5006438574712988
09/12/2019,2019-09-12,22,8,2,32,9.125482893103475
09/17/2019,2019-09-17,5,2,0,7,8.594112169827607
09/18/2019,2019-09-18,1,0,0,1,6.695584127370705
09/20/2019,2019-09-20,5,1,0,6,6.521688095528029
09/27/2019,2019-09-27,7,4,0,11,7.641266071646022
10/01/2019,2019-10-01,0,1,0,1,5.980949553734516
10/02/2019,2019-10-02,0,1,0,1,4.735712165300886
10/04/2019,2019-10-04,5,2,1,8,5.551784123975665
10/07/2019,2019-10-07,1,1,0,2,4.663838092981749
10/08/2019,2019-10-08,1,0,0,1,3.7478785697363115
10/10/2019,2019-10-10,3,3,1,7,4.560908927302234
10/11/2019,2019-10-11,1,1,0,2,3.920681695476675
10/16/2019,2019-10-16,0,1,0,1,3.190511271607506
10/17/2019,2019-10-17,0,1,0,1,2.6428834537056294
10/18/2019,2019-10-18,6,2,0,8,3.982162590279222
10/21/2019,2019-10-21,1,1,0,2,3.4866219427094167
10/22/2019,2019-10-22,1,0,0,1,2.8649664570320623
10/23/2019,2019-10-23,6,0,0,6,3.648724842774047
10/25/2019,2019-10-25,2,1,0,3,3.486543632080535
10/28/2019,2019-10-28,1,0,0,1,2.864907724060401
10/29/2019,2019-10-29,0,1,0,1,2.3986807930453007
11/01/2019,2019-11-01,1,1,0,2,2.2990105947839754
11/02/2019,2019-11-02,0,0,1,1,1.9742579460879814
11/03/2019,2019-11-03,1,0,0,1,1.7306934595659862
11/06/2019,2019-11-06,0,1,0,1,1.5480200946744898
11/07/2019,2019-11-07,3,2,1,6,2.6610150710058673
11/08/2019,2019-11-08,1,1,0,2,2.4957613032544
11/11/2019,2019-11-11,0,1,0,1,2.1218209774408
11/13/2019,2019-11-13,1,0,0,1,1.8413657330806
11/14/2019,2019-11-14,1,0,0,1,1.63102429981045
11/15/2019,2019-11-15,1,1,0,2,1.7232682248578377
11/20/2019,2019-11-20,1,1,0,2,1.7924511686433784
11/21/2019,2019-11-21,0,1,0,1,1.5943383764825338
11/27/2019,2019-11-27,0,2,0,2,1.6957537823619004
12/01/2019,2019-12-01,0,2,0,2,1.7718153367714253
12/06/2019,2019-12-06,1,5,0,6,2.828861502578569
12/07/2019,2019-12-07,1,0,0,1,2.3716461269339266
12/09/2019,2019-12-09,0,1,0,1,2.028734595200445
12/12/2019,2019-12-12,0,3,0,3,2.2715509464003336
12/15/2019,2019-12-15,1,0,0,1,1.9536632098002502
12/17/2019,2019-12-17,1,1,0,2,1.9652474073501878
12/20/2019,2019-12-20,1,2,1,4,2.4739355555126408
12/26/2019,2019-12-26,1,0,0,1,2.1054516666344805
01/03/2020,2020-01-03,1,0,0,1,1.8290887499758604
01/04/2020,2020-01-04,1,0,0,1,1.6218165624818952
01/10/2020,2020-01-10,2,2,0,4,2.2163624218614215
01/17/2020,2020-01-17,1,1,0,2,2.162271816396066
01/21/2020,2020-01-21,0,1,0,1,1.8717038622970494
01/24/2020,2020-01-24,1,1,0,2,1.9037778967227872
01/31/2020,2020-01-31,1,2,0,3,2.1778334225420903
02/01/2020,2020-02-01,0,1,0,1,1.8833750669065676
02/07/2020,2020-02-07,0,1,0,1,1.6625313001799258
02/12/2020,2020-02-12,1,0,0,1,1.4968984751349441
02/14/2020,2020-02-14,0,1,0,1,1.372673856351208
02/20/2020,2020-02-20,0,1,0,1,1.2795053922634059
02/21/2020,2020-02-21,0,2,0,2,1.4596290441975543
02/27/2020,2020-02-27,0,3,0,3,1.844721783148166
02/28/2020,2020-02-28,0,1,0,1,1.6335413373611245
03/05/2020,2020-03-05,0,3,0,3,1.9751560030208435
03/07/2020,2020-03-07,0,1,0,1,1.7313670022656327
03/10/2020,2020-03-10,0,1,0,1,1.5485252516992245
03/11/2020,2020-03-11,0,1,0,1,1.4113939387744183
03/23/2020,2020-03-23,0,1,0,1,1.3085454540808137
03/26/2020,2020-03-26,0,1,0,1,1.23140909056061
04/03/2020,2020-04-03,1,0,1,2,1.4235568179204576
04/17/2020,2020-04-17,1,0,0,1,1.317667613440343
05/01/2020,2020-05-01,0,2,0,2,1.4882507100802573
05/15/2020,2020-05-15,0,2,0,2,1.6161880325601932
06/03/2020,2020-06-03,0,1,0,1,1.4621410244201447
06/05/2020,2020-06-05,0,1,0,1,1.3466057683151085
06/10/2020,2020-06-10,1,3,0,4,2.0099543262363313
07/01/2020,2020-07-01,0,1,0,1,1.7574657446772484
07/17/2020,2020-07-17,0,1,0,1,1.5680993085079362
09/07/2020,2020-09-07,3,2,0,5,2.4260744813809523
09/16/2020,2020-09-16,5,0,0,5,3.0695558610357145
09/17/2020,2020-09-17,1,0,0,1,2.552166895776786
09/18/2020,2020-09-18,1,1,0,2,2.4141251718325893
09/23/2020,2020-09-23,2,1,0,3,2.560593878874442
09/25/2020,2020-09-25,3,0,0,3,2.6704454091558314
09/30/2020,2020-09-30,1,1,0,2,2.5028340568668734
10/01/2020,2020-10-01,1,0,0,1,2.127125542650155
10/02/2020,2020-10-02,1,0,0,1,1.8453441569876161
10/06/2020,2020-10-06,1,0,0,1,1.6340081177407122
10/11/2020,2020-10-11,2,4,0,6,2.725506088305534
10/18/2020,2020-10-18,4,0,0,4,3.044129566229151
10/20/2020,2020-10-20,2,0,0,2,2.783097174671863
10/23/2020,2020-10-23,1,1,0,2,2.587322881003897
10/25/2020,2020-10-25,2,0,0,2,2.4404921607529224
10/26/2020,2020-10-26,0,1,0,1,2.0803691205646917
10/27/2020,2020-10-27,0,1,0,1,1.8102768404235188
10/28/2020,2020-10-28,3,0,0,3,2.107707630317639
10/29/2020,2020-10-29,2,0,0,2,2.080780722738229
11/03/2020,2020-11-03,2,0,0,2,2.060585542053672
11/05/2020,2020-11-05,1,0,0,1,1.7954391565402539
11/12/2020,2020-11-12,3,0,0,3,2.0965793674051905
11/16/2020,2020-11-16,0,1,0,1,1.8224345255538927
11/17/2020,2020-11-17,1,1,0,2,1.8668258941654197
11/20/2020,2020-11-20,1,0,0,1,1.6501194206240648
11/23/2020,2020-11-23,1,0,0,1,1.4875895654680484
11/24/2020,2020-11-24,1,0,0,1,1.3656921741010362
12/01/2020,2020-12-01,2,0,0,2,1.5242691305757772
12/03/2020,2020-12-03,1,0,0,1,1.3932018479318327
12/10/2020,2020-12-10,1,1,0,2,1.5449013859488747
12/12/2020,2020-12-12,1,0,0,1,1.408676039461656
12/18/2020,2020-12-18,1,0,0,1,1.306507029596242
12/20/2020,2020-12-20,1,0,0,1,1.2298802721971813
12/24/2020,2020-12-24,3,1,0,4,1.922410204147886
01/08/2021,2021-01-08,2,2,0,4,2.4418076531109145
01/09/2021,2021-01-09,1,0,0,1,2.0813557398331857
01/15/2021,2021-01-15,2,4,0,6,3.06101680487489
01/21/2021,2021-01-21,0,1,0,1,2.545762603656167
01/27/2021,2021-01-27,1,1,0,2,2.409321952742125
02/09/2021,2021-02-09,0,2,0,2,2.3069914645565937
02/12/2021,2021-02-12,0,2,0,2,2.230243598417445
02/22/2021,2021-02-22,1,0,0,1,1.9226826988130838
02/25/2021,2021-02-25,1,1,0,2,1.9420120241098129
02/28/2021,2021-02-28,0,1,0,1,1.7065090180823597
03/03/2021,2021-03-03,1,0,0,1,1.5298817635617699
03/05/2021,2021-03-05,3,3,0,6,2.6474113226713274
03/12/2021,2021-03-12,0,5,0,5,3.235558492003496
03/13/2021,2021-03-13,0,1,0,1,2.6766688690026217
03/15/2021,2021-03-15,0,1,0,1,2.257501651751966
03/17/2021,2021-03-17,1,2,0,3,2.4431262388139747
03/19/2021,2021-03-19,0,1,0,1,2.082344679110481
03/25/2021,2021-03-25,1,3,0,4,2.561758509332861
03/26/2021,2021-03-26,0,2,0,2,2.4213188819996456
04/02/2021,2021-04-02,0,6,0,6,3.3159891614997345
04/04/2021,2021-04-04,0,1,0,1,2.7369918711248005
04/08/2021,2021-04-08,1,0,0,1,2.3027439033436004
04/10/2021,2021-04-10,0,1,0,1,1.9770579275077003
04/14/2021,2021-04-14,0,2,0,2,1.9827934456307752
04/20/2021,2021-04-20,1,0,0,1,1.7370950842230815
04/22/2021,2021-04-22,0,2,0,2,1.8028213131673112
04/27/2021,2021-04-27,0,1,0,1,1.6021159848754833
04/30/2021,2021-04-30,0,2,0,2,1.7015869886566126
05/03/2021,2021-05-03,0,1,0,1,1.5261902414924595
05/05/2021,2021-05-05,1,0,0,1,1.3946426811193444
05/13/2021,2021-05-13,0,1,0,1,1.2959820108395081
05/14/2021,2021-05-14,0,2,0,2,1.471986508129631
05/18/2021,2021-05-18,0,3,0,3,1.8539898810972235
05/19/2021,2021-05-19,0,2,0,2,1.8904924108229177
05/20/2021,2021-05-20,0,1,0,1,1.6678693081171883
05/28/2021,2021-05-28,0,1,0,1,1.5009019810878912
06/04/2021,2021-06-04,0,2,0,2,1.6256764858159185
06/07/2021,2021-06-07,0,1,0,1,1.4692573643619387
06/08/2021,2021-06-08,0,2,0,2,1.6019430232714542
06/14/2021,2021-06-14,0,1,0,1,1.4514572674535906
06/21/2021,2021-06-21,0,1,0,1,1.3385929505901928
06/30/2021,2021-06-30,0,2,0,2,1.5039447129426446
07/06/2021,2021-07-06,0,1,0,1,1.3779585347069834
07/29/2021,2021-07-29,0,1,0,1,1.2834689010302374
08/24/2021,2021-08-24,0,1,0,1,1.2126016757726779
08/30/2021,2021-08-30,2,1,0,3,1.6594512568295086
09/01/2021,2021-09-01,1,0,0,1,1.4945884426221312
09/08/2021,2021-09-08,5,3,0,8,3.120941331966599
09/09/2021,2021-09-09,0,1,0,1,2.590705998974949
09/10/2021,2021-09-10,1,0,0,1,2.1930294992312116
09/13/2021,2021-09-13,1,1,0,2,2.1447721244234086
09/14/2021,2021-09-14,2,1,0,3,2.3585790933175566
09/15/2021,2021-09-15,2,0,0,2,2.2689343199881673
09/16/2021,2021-09-16,0,1,0,1,1.9517007399911255
09/17/2021,2021-09-17,1,0,0,1,1.7137755549933442
09/20/2021,2021-09-20,1,1,0,2,1.7853316662450083
09/22/2021,2021-09-22,3,1,0,4,2.338998749683756
09/23/2021,2021-09-23,1,0,0,1,2.004249062262817
09/24/2021,2021-09-24,2,0,0,2,2.0031867966971126
09/25/2021,2021-09-25,5,1,0,6,3.002390097522835
09/29/2021,2021-09-29,2,3,0,5,3.501792573142126
09/30/2021,2021-09-30,3,0,0,3,3.3763444298565948
10/03/2021,2021-10-03,1,0,0,1,2.7822583223924457
10/05/2021,2021-10-05,3,0,0,3,2.8366937417943343
10/09/2021,2021-10-09,3,2,0,5,3.377520306345751
10/10/2021,2021-10-10,0,1,0,1,2.783140229759313
10/11/2021,2021-10-11,2,0,0,2,2.5873551723194845
10/14/2021,2021-10-14,2,0,0,2,2.440516379239613
10/18/2021,2021-10-18,0,1,0,1,2.08038728442971
10/19/2021,2021-10-19,0,1,0,1,1.8102904633222825
10/20/2021,2021-10-20,1,0,0,1,1.607717847491712
10/21/2021,2021-10-21,4,0,0,4,2.205788385618784
10/25/2021,2021-10-25,2,0,0,2,2.154341289214088
10/27/2021,2021-10-27,2,1,0,3,2.365755966910566
10/28/2021,2021-10-28,1,0,0,1,2.0243169751829244
11/01/2021,2021-11-01,4,0,0,4,2.518237731387193
11/02/2021,2021-11-02,1,0,0,1,2.1386782985403947
11/03/2021,2021-11-03,3,1,0,4,2.604008723905296
11/04/2021,2021-11-04,0,3,0,3,2.703006542928972
11/05/2021,2021-11-05,1,1,0,2,2.5272549071967285
11/07/2021,2021-11-07,1,0,0,1,2.145441180397546
11/09/2021,2021-11-09,1,4,0,5,2.8590808852981597
11/11/2021,2021-11-11,3,1,0,4,3.14431066397362
11/12/2021,2021-11-12,2,2,0,4,3.358232997980215
11/15/2021,2021-11-15,1,0,0,1,2.768674748485161
11/16/2021,2021-11-16,0,1,0,1,2.3265060613638706
11/17/2021,2021-11-17,3,3,0,6,3.2448795460229034
11/18/2021,2021-11-18,0,1,0,1,2.6836596595171773
11/19/2021,2021-11-19,1,1,0,2,2.512744744637883
11/26/2021,2021-11-26,0,1,0,1,2.134558558478412
11/27/2021,2021-11-27,1,1,0,2,2.100918918858809
11/30/2021,2021-11-30,2,2,0,4,2.5756891891441067
12/01/2021,2021-12-01,1,0,0,1,2.18176689185808
12/05/2021,2021-12-05,2,3,0,5,2.88632516889356
12/07/2021,2021-12-07,0,3,0,3,2.91474387667017
12/08/2021,2021-12-08,1,0,0,1,2.436057907502627
12/09/2021,2021-12-09,2,0,0,2,2.3270434306269703
12/12/2021,2021-12-12,1,0,0,1,1.9952825729702277
12/14/2021,2021-12-14,1,2,0,3,2.246461929727671
12/20/2021,2021-12-20,2,4,0,6,3.1848464472957536
12/26/2021,2021-12-26,2,2,0,4,3.3886348354718154
12/29/2021,2021-12-29,1,0,0,1,2.7914761266038615
01/03/2022,2022-01-03,1,0,0,1,2.3436070949528958
01/04/2022,2022-01-04,0,1,0,1,2.007705321214672
01/07/2022,2022-01-07,1,1,0,2,2.0057789909110038
01/16/2022,2022-01-16,1,1,0,2,2.0043342431832527
01/20/2022,2022-01-20,0,2,0,2,2.0032506823874394
01/24/2022,2022-01-24,0,1,0,1,1.7524380117905796
01/25/2022,2022-01-25,1,1,0,2,1.8143285088429346
01/27/2022,2022-01-27,0,1,0,1,1.610746381632201
02/01/2022,2022-02-01,0,2,0,2,1.7080597862241509
02/02/2022,2022-02-02,0,2,0,2,1.7810448396681133
02/03/2022,2022-02-03,0,1,0,1,1.585783629751085
02/05/2022,2022-02-05,1,0,0,1,1.4393377223133137
02/07/2022,2022-02-07,0,1,0,1,1.3295032917349852
02/10/2022,2022-02-10,0,3,0,3,1.747127468801239
02/18/2022,2022-02-18,3,4,0,7,3.06034560160093
02/22/2022,2022-02-22,0,3,0,3,3.0452592012006976
02/23/2022,2022-02-23,1,0,0,1,2.533944400900523
02/24/2022,2022-02-24,1,0,0,1,2.150458300675392
02/28/2022,2022-02-28,0,1,0,1,1.862843725506544
03/02/2022,2022-03-02,1,1,0,2,1.897132794129908
03/06/2022,2022-03-06,1,2,0,3,2.172849595597431
03/08/2022,2022-03-08,0,1,0,1,1.8796371966980734
03/09/2022,2022-03-09,1,1,0,2,1.909727897523555
03/10/2022,2022-03-10,1,2,0,3,2.182295923142666
03/17/2022,2022-03-17,0,3,0,3,2.3867219423569996
03/23/2022,2022-03-23,0,4,0,4,2.79004145676775
03/25/2022,2022-03-25,0,2,0,2,2.592531092575812
03/29/2022,2022-03-29,0,3,0,3,2.694398319431859
03/30/2022,2022-03-30,0,1,0,1,2.2707987395738938
04/05/2022,2022-04-05,1,1,0,2,2.20309905468042
04/07/2022,2022-04-07,0,1,0,1,1.902324291010315
04/11/2022,2022-04-11,0,1,0,1,1.6767432182577364
04/13/2022,2022-04-13,0,4,0,4,2.2575574136933025
04/19/2022,2022-04-19,0,1,0,1,1.9431680602699768
04/25/2022,2022-04-25,0,3,0,3,2.2073760452024827
04/26/2022,2022-04-26,1,0,0,1,1.905532033901862
05/04/2022,2022-05-04,1,5,0,6,2.9291490254263963
05/09/2022,2022-05-09,0,2,0,2,2.696861769069797
05/13/2022,2022-05-13,1,1,0,2,2.5226463268023473
05/19/2022,2022-05-19,0,1,0,1,2.14198474510176
05/20/2022,2022-05-20,0,1,0,1,1.85648855882632
05/25/2022,2022-05-25,0,1,0,1,1.64236641911974
05/26/2022,2022-05-26,0,1,0,1,1.4817748143398048
05/27/2022,2022-05-27,0,1,0,1,1.3613311107548536
05/30/2022,2022-05-30,0,5,0,5,2.2709983330661405
06/02/2022,2022-06-02,0,1,0,1,1.9532487497996054
06/13/2022,2022-06-13,0,2,0,2,1.9649365623497042
06/22/2022,2022-06-22,0,1,0,1,1.723702421762278
08/17/2022,2022-08-17,1,0,0,1,1.5427768163217086
08/29/2022,2022-08-29,1,0,0,1,1.4070826122412814
09/01/2022,2022-09-01,3,2,0,5,2.305311959180961
09/06/2022,2022-09-06,1,0,0,1,1.9789839693857207
09/08/2022,2022-09-08,1,0,0,1,1.7342379770392906
09/12/2022,2022-09-12,2,1,0,3,2.050678482779468
09/14/2022,2022-09-14,4,0,0,4,2.538008862084601
09/15/2022,2022-09-15,1,4,0,5,3.153506646563451
09/16/2022,2022-09-16,2,1,0,3,3.1151299849225884
09/19/2022,2022-09-19,1,2,0,3,3.0863474886919415
09/20/2022,2022-09-20,2,0,0,2,2.814760616518956
09/22/2022,2022-09-22,4,1,0,5,3.3610704623892174
09/24/2022,2022-09-24,0,1,0,1,2.770802846791913
09/28/2022,2022-09-28,4,3,0,7,3.828102135093935
10/02/2022,2022-10-02,0,1,0,1,3.121076601320451
10/04/2022,2022-10-04,3,1,0,4,3.3408074509903387
10/05/2022,2022-10-05,2,0,0,2,3.005605588242754
10/06/2022,2022-10-06,2,0,0,2,2.7542041911820654
10/10/2022,2022-10-10,7,2,0,9,4.315653143386549
10/11/2022,2022-10-11,2,0,0,2,3.7367398575399116
10/13/2022,2022-10-13,4,3,0,7,4.552554893154934
10/18/2022,2022-10-18,4,5,0,9,5.6644161698662
10/20/2022,2022-10-20,1,0,0,1,4.49831212739965
10/21/2022,2022-10-21,0,2,0,2,3.8737340955497377
10/26/2022,2022-10-26,2,2,0,4,3.9053005716623033
10/27/2022,2022-10-27,1,0,0,1,3.1789754287467273
10/28/2022,2022-10-28,2,0,0,2,2.8842315715600453
11/01/2022,2022-11-01,2,4,0,6,3.6631736786700344
11/05/2022,2022-11-05,1,2,0,3,3.497380259002526
11/08/2022,2022-11-08,7,0,0,7,4.373035194251894
11/09/2022,2022-11-09,0,1,0,1,3.5297763956889208
11/11/2022,2022-11-11,1,2,0,3,3.397332296766691
11/14/2022,2022-11-14,1,1,0,2,3.0479992225750183
11/15/2022,2022-11-15,1,0,0,1,2.5359994169312636
11/17/2022,2022-11-17,1,2,0,3,2.6519995626984474
11/18/2022,2022-11-18,1,1,0,2,2.4889996720238354
11/20/2022,2022-11-20,1,1,0,2,2.3667497540178766
11/22/2022,2022-11-22,8,1,0,9,4.0250623155134075
11/28/2022,2022-11-28,1,2,0,3,3.7687967366350557
11/29/2022,2022-11-29,2,0,0,2,3.326597552476292
12/02/2022,2022-12-02,0,1,0,1,2.7449481643572184
12/04/2022,2022-12-04,1,0,0,1,2.308711123267914
12/05/2022,2022-12-05,1,0,0,1,1.9815333424509354
12/08/2022,2022-12-08,0,3,0,3,2.2361500068382014
12/20/2022,2022-12-20,3,3,0,6,3.1771125051286515
01/04/2023,2023-01-04,1,0,0,1,2.6328343788464883
01/10/2023,2023-01-10,2,1,0,3,2.724625784134866
01/16/2023,2023-01-16,1,2,0,3,2.7934693381011493
01/19/2023,2023-01-19,1,1,0,2,2.5951020035758616
01/27/2023,2023-01-27,0,3,0,3,2.696326502681896
02/02/2023,2023-02-02,2,2,0,4,3.0222448770114223
02/09/2023,2023-02-09,2,1,0,3,3.0166836577585667
02/16/2023,2023-02-16,0,1,0,1,2.5125127433189247
02/17/2023,2023-02-17,0,3,0,3,2.6343845574891933
02/27/2023,2023-02-27,0,2,0,2,2.475788418116895
03/08/2023,2023-03-08,0,5,0,5,3.1068413135876716
03/10/2023,2023-03-10,0,2,0,2,2.8301309851907535
03/17/2023,2023-03-17,0,1,0,1,2.372598238893065
03/22/2023,2023-03-22,0,2,0,2,2.2794486791697985
03/24/2023,2023-03-24,0,1,0,1,1.9595865093773488
03/29/2023,2023-03-29,1,1,0,2,1.9696898820330115
04/11/2023,2023-04-11,0,3,0,3,2.2272674115247586
04/18/2023,2023-04-18,0,2,0,2,2.170450558643569
05/01/2023,2023-05-01,0,2,0,2,2.1278379189826766
05/10/2023,2023-05-10,1,3,0,4,2.5958784392370076
05/16/2023,2023-05-16,2,4,0,6,3.446908829427756
05/23/2023,2023-05-23,0,1,0,1,2.8351816220708166
06/05/2023,2023-06-05,0,2,0,2,2.6263862165531124
06/13/2023,2023-06-13,0,2,0,2,2.469789662414834
06/23/2023,2023-06-23,0,2,0,2,2.3523422468111255
07/05/2023,2023-07-05,0,1,0,1,2.014256685108344
08/01/2023,2023-08-01,1,0,0,1,1.760692513831258
08/10/2023,2023-08-10,1,0,0,1,1.5705193853734434
08/28/2023,2023-08-28,1,0,0,1,1.4278895390300823
09/01/2023,2023-09-01,3,3,0,6,2.570917154272562
09/08/2023,2023-09-08,6,2,0,8,3.928187865704422
09/09/2023,2023-09-09,1,0,0,1,3.1961408992783165
09/12/2023,2023-09-12,2,1,0,3,3.1471056744587376
09/13/2023,2023-09-13,1,0,0,1,2.6103292558440527
09/14/2023,2023-09-14,0,2,0,2,2.4577469418830393
09/18/2023,2023-09-18,6,4,0,10,4.34331020641228
09/24/2023,2023-09-24,2,0,0,2,3.75748265480921
09/26/2023,2023-09-26,6,0,0,6,4.318111991106908
09/30/2023,2023-09-30,5,3,0,8,5.238583993330181
10/02/2023,2023-10-02,1,0,0,1,4.178937994997636
10/03/2023,2023-10-03,3,3,0,6,4.634203496248227
10/05/2023,2023-10-05,2,0,0,2,3.97565262218617
10/06/2023,2023-10-06,0,1,0,1,3.2317394666396275
10/09/2023,2023-10-09,2,0,0,2,2.92380459997972
10/12/2023,2023-10-12,3,0,0,3,2.94285344998479
10/16/2023,2023-10-16,2,0,0,2,2.7071400874885923
10/19/2023,2023-10-19,2,0,0,2,2.530355065616444
10/20/2023,2023-10-20,1,0,0,1,2.147766299212333
10/22/2023,2023-10-22,4,1,0,5,2.8608247244092495
10/30/2023,2023-10-30,8,0,0,8,4.145618543306937
11/07/2023,2023-11-07,7,6,0,13,6.359213907480203
11/08/2023,2023-11-08,0,1,0,1,5.019410430610152
11/13/2023,2023-11-13,7,2,0,9,6.014557822957614
11/17/2023,2023-11-17,0,1,0,1,4.76091836721821
11/27/2023,2023-11-27,4,0,0,4,4.570688775413657
11/30/2023,2023-11-30,1,0,0,1,3.678016581560243
12/04/2023,2023-12-04,2,0,0,2,3.2585124361701823
12/13/2023,2023-12-13,2,2,0,4,3.4438843271276367
12/19/2023,2023-12-19,3,2,0,5,3.8329132453457277
01/02/2024,2024-01-02,1,0,0,1,3.124684934009296
01/05/2024,2024-01-05,0,2,0,2,2.8435137005069717
01/10/2024,2024-01-10,2,3,0,5,3.382635275380229
01/15/2024,2024-01-15,1,1,0,2,3.036976456535172
01/24/2024,2024-01-24,3,3,0,6,3.777732342401379
01/29/2024,2024-01-29,1,0,0,1,3.0832992568010344
02/08/2024,2024-02-08,0,3,0,3,3.062474442600776
02/15/2024,2024-02-15,4,2,0,6,3.796855831950582
02/21/2024,2024-02-21,0,1,0,1,3.0976418739629366
03/11/2024,2024-03-11,1,10,0,11,5.073231405472202
03/25/2024,2024-03-25,0,1,0,1,4.0549235541041515
03/26/2024,2024-03-26,0,1,0,1,3.2911926655781136
04/02/2024,2024-04-02,0,3,0,3,3.2183944991835856
04/14/2024,2024-04-14,0,2,0,2,2.913795874387689
04/18/2024,2024-04-18,0,4,0,4,3.185346905790767
04/25/2024,2024-04-25,0,1,0,1,2.639010179343075
04/30/2024,2024-04-30,0,1,0,1,2.229257634507306
05/09/2024,2024-05-09,0,1,0,1,1.9219432258804794
05/30/2024,2024-05-30,1,4,0,5,2.6914574194103595
06/05/2024,2024-06-05,0,1,0,1,2.2685930645577694
06/26/2024,2024-06-26,1,0,0,1,1.951444798418327
08/20/2024,2024-08-20,8,5,0,13,4.713583598813746
08/24/2024,2024-08-24,0,1,0,1,3.7851876991103093
08/26/2024,2024-08-26,1,1,0,2,3.338890774332732
09/02/2024,2024-09-02,1,0,0,1,2.7541680807495488
09/05/2024,2024-09-05,2,0,0,2,2.5656260605621615
09/09/2024,2024-09-09,7,1,0,8,3.9242195454216215
09/12/2024,2024-09-12,6,1,0,7,4.693164659066216
09/16/2024,2024-09-16,2,1,0,3,4.269873494299662
09/17/2024,2024-09-17,1,0,0,1,3.4524051207247464
09/19/2024,2024-09-19,1,1,0,2,3.0893038405435598
09/20/2024,2024-09-20,7,0,0,7,4.06697788040767
09/23/2024,2024-09-23,1,0,0,1,3.3002334103057525
09/24/2024,2024-09-24,1,0,0,1,2.725175057729314
09/25/2024,2024-09-25,3,0,0,3,2.793881293296985
10/01/2024,2024-10-01,2,4,0,6,3.5954109699727392
10/02/2024,2024-10-02,0,2,0,2,3.1965582274795543
10/07/2024,2024-10-07,3,0,0,3,3.147418670609666
10/09/2024,2024-10-09,2,2,0,4,3.3605640029572497
10/14/2024,2024-10-14,2,2,0,4,3.5204230022179375
10/21/2024,2024-10-21,8,2,0,10,5.140317251663453
10/22/2024,2024-10-22,2,0,0,2,4.35523793874759
10/29/2024,2024-10-29,5,3,0,8,5.2664284540606925
11/04/2024,2024-11-04,2,0,0,2,4.449821340545519
11/05/2024,2024-11-05,3,5,0,8,5.337366005409139
11/08/2024,2024-11-08,1,0,0,1,4.253024504056854
11/11/2024,2024-11-11,2,3,0,5,4.439768378042641
11/14/2024,2024-11-14,2,0,0,2,3.8298262835319803
11/18/2024,2024-11-18,0,1,0,1,3.122369712648985
11/26/2024,2024-11-26,1,1,0,2,2.8417772844867386
11/27/2024,2024-11-27,1,3,0,4,3.1313329633650544
12/05/2024,2024-12-05,2,3,0,5,3.598499722523791
12/06/2024,2024-12-06,0,1,0,1,2.948874791892843
12/17/2024,2024-12-17,0,1,0,1,2.461656093919632
12/24/2024,2024-12-24,0,3,0,3,2.596242070439724
01/16/2025,2025-01-16,1,2,0,3,2.6971815528297927
01/23/2025,2025-01-23,1,1,0,2,2.5228861646223444
01/25/2025,2025-01-25,0,1,0,1,2.142164623466758
01/30/2025,2025-01-30,0,1,0,1,1.8566234676000684
02/06/2025,2025-02-06,0,4,0,4,2.3924676007000514
